Country/Territory,Code,Year,Infectious diseases,Chronic non-communicable diseases,Nutritional and metabolic diseases,Maternal and child diseases,Traumatic injuries,Others,Sum
Afghanistan,AFG,1990,37908,77406,4141,18267,6543,3706,147971
Afghanistan,AFG,1991,39714,78540,4272,20013,8293,6012,156844
Afghanistan,AFG,1992,44590,80632,4845,23375,8449,7265,169156
Afghanistan,AFG,1993,51121,83169,5634,26006,8932,7368,182230
Afghanistan,AFG,1994,54192,85417,6119,27151,9383,12533,194795
Afghanistan,AFG,1995,56518,86847,6218,27757,9939,9249,196528
Afghanistan,AFG,1996,57834,88535,6305,28307,10005,7372,198358 
Afghanistan,AFG,1997,60050,90171,6453,28719,10503,10569,206465
Afghanistan,AFG,1998,60271,91267,6338,28407,17490,15997,219770
Afghanistan,AFG,1999,59006,92330,6183,27713,10347,8850,204429
Afghanistan,AFG,2000,57381,93226,6073,27191,10231,9136,203238
Afghanistan,AFG,2001,56681,94695,5897,27661,10418,9840,205192
Afghanistan,AFG,2002,57634,94313,5541,28474,11607,5100,202669
Afghanistan,AFG,2003,60364,95442,6023,29330,11396,5228,207783
Afghanistan,AFG,2004,58680,96392,6011,29579,11725,5468,207855
Afghanistan,AFG,2005,55942,96364,5703,29661,12260,6586,206516
Afghanistan,AFG,2006,52487,96392,5402,29113,11900,10225,205519
Afghanistan,AFG,2007,48898,96444,4927,28880,11639,12809,203597
Afghanistan,AFG,2008,45013,96740,4508,28812,12437,11607,199117
Afghanistan,AFG,2009,41807,96883,4038,28685,11033,12416,194862
Afghanistan,AFG,2010,40451,97339,3906,28761,11384,13343,195184
Afghanistan,AFG,2011,38820,98361,3651,28808,11129,14265,195034
Afghanistan,AFG,2012,37095,99573,3372,28793,11401,16609,196843
Afghanistan,AFG,2013,37121,100881,3341,28857,11879,17202,199281
Afghanistan,AFG,2014,35981,102384,3196,28633,12326,23435,205955
Afghanistan,AFG,2015,34818,104092,2974,28273,11836,29730,211723
Afghanistan,AFG,2016,34298,106433,2868,28168,11668,34135,217570
Afghanistan,AFG,2017,33361,109361,2699,28079,11986,25629,211115
Afghanistan,AFG,2018,31597,111698,2524,27943,11944,33685,219391
Afghanistan,AFG,2019,30995,113839,2454,27739,12167,30447,217641
Albania,ALB,1990,2374,12091,72,897,698,210,16342
Albania,ALB,1991,2433,12414,82,887,751,246,16813
Albania,ALB,1992,2329,12068,86,870,732,273,16358
Albania,ALB,1993,2185,11702,90,858,678,306,15819
Albania,ALB,1994,2002,11177,90,847,618,358,15092
Albania,ALB,1995,1786,11617,94,819,604,389,15309
Albania,ALB,1996,1601,12087,90,800,589,437,15604
Albania,ALB,1997,1436,12434,84,824,599,2536,17913
Albania,ALB,1998,1291,12700,74,845,617,555,16082
Albania,ALB,1999,1121,12954,61,787,572,482,15977
Albania,ALB,2000,962,13123,43,719,522,375,15744
Albania,ALB,2001,819,13002,31,669,504,325,15350
Albania,ALB,2002,742,13808,24,623,524,278,15999
Albania,ALB,2003,691,14920,19,575,541,237,16983
Albania,ALB,2004,623,15287,15,521,543,209,17198
Albania,ALB,2005,558,15329,13,476,520,160,17056
Albania,ALB,2006,493,14925,11,435,483,148,16495
Albania,ALB,2007,440,14690,10,397,476,149,16162
Albania,ALB,2008,416,15221,9,370,482,135,16633
Albania,ALB,2009,394,15427,9,339,464,112,16745
Albania,ALB,2010,387,15817,9,312,471,121,17117
Albania,ALB,2011,393,16462,9,297,469,121,17751
Albania,ALB,2012,403,16963,9,273,466,125,18239
Albania,ALB,2013,417,17533,9,247,465,120,18791
Albania,ALB,2014,435,18291,9,221,471,123,19550
Albania,ALB,2015,453,19068,9,202,478,123,20333
Albania,ALB,2016,465,19562,9,189,474,123,20822
Albania,ALB,2017,474,20041,9,179,464,128,21295
Albania,ALB,2018,482,20501,8,171,456,120,21738
Albania,ALB,2019,491,20953,8,164,500,119,22235
Algeria,DZA,1990,13349,81929,875,19565,17163,1261,134142
Algeria,DZA,1991,12514,83898,847,18962,16722,1318,134261
Algeria,DZA,1992,11929,85870,823,18400,16724,1775,135521
Algeria,DZA,1993,11432,87905,803,17864,16778,2119,136901
Algeria,DZA,1994,10958,90101,772,17234,17192,3780,140037
Algeria,DZA,1995,10468,91805,739,16567,17001,4837,141417
Algeria,DZA,1996,9978,93236,703,15977,17027,3005,139926
Algeria,DZA,1997,9726,94600,682,15489,17216,6584,144297
Algeria,DZA,1998,9417,95605,655,15030,17145,6007,143859
Algeria,DZA,1999,9185,97898,619,14702,17306,3019,142729
Algeria,DZA,2000,8919,99243,587,14447,17172,4053,144421
Algeria,DZA,2001,8666,100574,538,14176,17850,2866,144670
Algeria,DZA,2002,8406,101986,481,13992,16733,3142,144740
Algeria,DZA,2003,8147,103106,423,13878,18319,2493,146366
Algeria,DZA,2004,8011,105073,379,13792,15785,2066,145106
Algeria,DZA,2005,7863,107055,345,13722,15501,1795,146281
Algeria,DZA,2006,7734,109148,313,13668,15179,1863,147905
Algeria,DZA,2007,7637,111530,286,13580,14961,2137,150131
Algeria,DZA,2008,7482,113939,263,13512,14701,1943,151840
Algeria,DZA,2009,7425,116844,245,13404,14412,2072,154402
Algeria,DZA,2010,7382,119658,234,13196,14135,1751,156356
Algeria,DZA,2011,7401,123286,227,12965,14101,1783,159763
Algeria,DZA,2012,7429,126934,221,12647,14064,1735,163030
Algeria,DZA,2013,7490,130498,218,12479,14001,1693,166379
Algeria,DZA,2014,7603,135110,218,12345,14042,1576,170894
Algeria,DZA,2015,7653,139955,216,12039,14005,1575,175443
Algeria,DZA,2016,7465,143909,212,11494,13718,1539,178337
Algeria,DZA,2017,7462,148677,208,10678,13625,1553,182203
Algeria,DZA,2018,7522,154453,207,9991,13841,1547,187561
Algeria,DZA,2019,7573,159739,206,9394,13875,1500,192287
American Samoa,ASM,1990,15,156,4,13,12,4,204
American Samoa,ASM,1991,15,163,4,13,13,4,212
American Samoa,ASM,1992,15,169,4,13,13,5,219
American Samoa,ASM,1993,15,175,4,13,13,6,226
American Samoa,ASM,1994,15,179,4,13,13,6,230
American Samoa,ASM,1995,16,187,4,13,13,6,239
American Samoa,ASM,1996,16,194,4,12,13,6,245
American Samoa,ASM,1997,16,200,4,12,14,6,252
American Samoa,ASM,1998,16,206,4,12,13,6,257
American Samoa,ASM,1999,16,211,4,12,13,6,262
American Samoa,ASM,2000,15,216,4,11,14,6,266
American Samoa,ASM,2001,16,223,4,11,14,6,274
American Samoa,ASM,2002,16,228,4,11,13,6,278
American Samoa,ASM,2003,17,232,4,10,19,6,288
American Samoa,ASM,2004,17,237,4,10,13,5,286
American Samoa,ASM,2005,17,243,4,9,12,6,291
American Samoa,ASM,2006,17,246,4,8,12,6,293
American Samoa,ASM,2007,16,250,4,8,12,6,296
American Samoa,ASM,2008,17,257,4,7,12,5,302
American Samoa,ASM,2009,17,262,4,7,46,4,340
American Samoa,ASM,2010,17,266,4,7,12,4,310
American Samoa,ASM,2011,17,272,4,6,12,4,315
American Samoa,ASM,2012,17,277,4,6,12,4,320
American Samoa,ASM,2013,17,284,4,6,14,5,330
American Samoa,ASM,2014,17,289,4,6,13,5,334
American Samoa,ASM,2015,17,295,4,6,13,4,339
American Samoa,ASM,2016,18,302,4,6,13,4,347
American Samoa,ASM,2017,18,306,4,5,13,4,350
American Samoa,ASM,2018,17,311,4,5,13,4,354
American Samoa,ASM,2019,17,317,4,5,13,4,360
Andorra,AND,1990,8,214,0,1,14,2,239
Andorra,AND,1991,9,227,0,1,15,2,254
Andorra,AND,1992,10,243,0,1,16,2,272
Andorra,AND,1993,10,258,0,1,17,2,288
Andorra,AND,1994,11,272,0,1,16,2,302
Andorra,AND,1995,12,278,0,1,16,2,309
Andorra,AND,1996,12,286,0,1,16,2,317
Andorra,AND,1997,13,295,0,1,16,2,327
Andorra,AND,1998,13,304,0,1,16,2,336
Andorra,AND,1999,14,314,0,1,16,1,346
Andorra,AND,2000,14,328,0,1,15,1,359
Andorra,AND,2001,15,340,0,1,15,1,372
Andorra,AND,2002,15,352,0,1,15,1,384
Andorra,AND,2003,16,366,0,1,16,1,400
Andorra,AND,2004,18,383,0,1,17,2,421
Andorra,AND,2005,18,392,0,1,17,2,430
Andorra,AND,2006,19,405,0,1,17,2,444
Andorra,AND,2007,19,417,0,1,18,2,457
Andorra,AND,2008,20,433,0,1,17,2,473
Andorra,AND,2009,22,450,0,1,17,2,492
Andorra,AND,2010,21,464,0,1,17,1,504
Andorra,AND,2011,21,451,0,1,15,1,489
Andorra,AND,2012,22,456,0,1,15,1,495
Andorra,AND,2013,23,465,0,1,15,1,505
Andorra,AND,2014,23,477,0,0,15,1,516
Andorra,AND,2015,24,491,0,0,16,1,532
Andorra,AND,2016,24,504,0,0,16,1,545
Andorra,AND,2017,25,519,0,0,16,1,561
Andorra,AND,2018,25,534,0,0,16,1,576
Andorra,AND,2019,25,545,0,0,16,1,587
Angola,AGO,1990,80196,29768,24174,15872,7559,3822,161391
Angola,AGO,1991,81661,30483,24111,16276,7763,1681,161975
Angola,AGO,1992,83058,31368,24011,16672,8042,3544,166695
Angola,AGO,1993,85739,32542,23959,17197,8470,13569,181476
Angola,AGO,1994,88651,33636,23565,17721,8871,5336,177780
Angola,AGO,1995,90183,34222,22894,18163,9048,1497,176007
Angola,AGO,1996,89807,34152,21850,18583,8930,1285,174607
Angola,AGO,1997,90484,34725,20784,19100,9177,4121,178391
Angola,AGO,1998,92775,36213,20042,19652,9945,15347,193974
Angola,AGO,1999,93858,37471,19215,20133,10645,8423,189745
Angola,AGO,2000,94754,38262,18458,20511,11098,4764,187847
Angola,AGO,2001,94845,38658,17828,20884,11289,4434,187938
Angola,AGO,2002,94239,39110,16914,21190,11329,1972,184754
Angola,AGO,2003,93887,40323,16311,21731,11644,1489,185385
Angola,AGO,2004,96698,42062,16535,22115,12448,1528,191386
Angola,AGO,2005,95627,42490,15770,22394,12324,1498,190103
Angola,AGO,2006,95496,43643,14941,22525,12433,1532,190570
Angola,AGO,2007,91864,44388,14197,22557,12619,1593,187218
Angola,AGO,2008,87767,45860,13340,22513,12578,1593,183651
Angola,AGO,2009,83112,47415,12329,22611,12619,1645,179731
Angola,AGO,2010,80829,49107,11726,22701,12767,1680,178810
Angola,AGO,2011,78626,50807,10797,22648,12868,1684,177430
Angola,AGO,2012,77158,52545,10024,22609,12749,1705,176790
Angola,AGO,2013,74765,53861,9165,22480,12478,1717,174466
Angola,AGO,2014,71625,54363,8374,22248,12149,1704,170463
Angola,AGO,2015,70733,56154,7828,21921,12210,1715,170561
Angola,AGO,2016,69987,57743,7285,21462,12012,1739,170228
Angola,AGO,2017,70150,60199,6588,21028,12162,1772,171899
Angola,AGO,2018,68646,62547,6108,20711,12293,1802,172107
Angola,AGO,2019,67823,64993,5921,20258,12517,1828,173340
Antigua and Barbuda,ATG,1990,35,341,7,10,13,6,412
Antigua and Barbuda,ATG,1991,34,350,8,10,13,7,422
Antigua and Barbuda,ATG,1992,35,355,8,10,13,7,428
Antigua and Barbuda,ATG,1993,38,378,8,11,14,7,456
Antigua and Barbuda,ATG,1994,40,380,8,11,15,7,461
Antigua and Barbuda,ATG,1995,40,382,6,12,17,8,465
Antigua and Barbuda,ATG,1996,40,360,6,12,15,7,440
Antigua and Barbuda,ATG,1997,37,354,6,12,47,8,464
Antigua and Barbuda,ATG,1998,37,354,6,12,17,7,433
Antigua and Barbuda,ATG,1999,40,356,6,11,17,8,438
Antigua and Barbuda,ATG,2000,42,357,6,11,15,8,439
Antigua and Barbuda,ATG,2001,41,355,6,11,15,10,438
Antigua and Barbuda,ATG,2002,40,358,6,10,15,9,438
Antigua and Barbuda,ATG,2003,38,360,5,10,14,9,436
Antigua and Barbuda,ATG,2004,38,363,5,9,14,9,438
Antigua and Barbuda,ATG,2005,37,367,4,9,14,9,440
Antigua and Barbuda,ATG,2006,37,377,4,8,14,8,448
Antigua and Barbuda,ATG,2007,39,424,6,8,13,10,500
Antigua and Barbuda,ATG,2008,39,428,6,7,13,9,502
Antigua and Barbuda,ATG,2009,35,407,4,7,13,11,477
Antigua and Barbuda,ATG,2010,37,412,4,6,13,10,482
Antigua and Barbuda,ATG,2011,37,420,4,6,14,11,492
Antigua and Barbuda,ATG,2012,37,427,4,6,15,11,500
Antigua and Barbuda,ATG,2013,36,434,4,5,15,11,505
Antigua and Barbuda,ATG,2014,40,448,4,5,15,10,522
Antigua and Barbuda,ATG,2015,41,461,6,5,15,10,538
Antigua and Barbuda,ATG,2016,40,471,6,5,15,10,547
Antigua and Barbuda,ATG,2017,40,480,6,5,16,11,558
Antigua and Barbuda,ATG,2018,40,489,6,5,16,12,568
Antigua and Barbuda,ATG,2019,40,500,6,4,16,12,578
Argentina,ARG,1990,12845,203861,2600,9855,8895,3494,241550
Argentina,ARG,1991,13185,204193,2598,9690,9142,3474,242282
Argentina,ARG,1992,13738,208110,2594,9122,9564,3636,246764
Argentina,ARG,1993,14186,208612,2555,8740,9800,3667,247560
Argentina,ARG,1994,14801,207004,2543,8259,10061,3815,246483
Argentina,ARG,1995,16138,210624,2683,7902,10298,3705,251350
Argentina,ARG,1996,17369,214077,2844,7694,10697,3842,256523
Argentina,ARG,1997,18700,218177,3104,7368,11117,3725,262191
Argentina,ARG,1998,20023,223732,3347,7381,11462,3553,269498
Argentina,ARG,1999,21291,227496,3494,6987,11622,3626,274516
Argentina,ARG,2000,22084,223375,3472,6567,11489,3957,270944
Argentina,ARG,2001,23533,225623,3524,6439,11694,3909,274722
Argentina,ARG,2002,25181,230171,3713,6691,11733,3981,281470
Argentina,ARG,2003,26773,233601,3678,6646,11573,3710,285981
Argentina,ARG,2004,27184,230442,3415,6211,11263,3322,281837
Argentina,ARG,2005,27518,228770,3150,5570,11387,3227,279622
Argentina,ARG,2006,28549,230700,2998,5322,11537,3495,282601
Argentina,ARG,2007,30317,237395,2954,5522,12064,3209,291461
Argentina,ARG,2008,30518,233660,2766,5493,12175,3587,288199
Argentina,ARG,2009,31725,235652,2672,5338,12261,3616,291264
Argentina,ARG,2010,33381,240874,2636,5234,12309,3633,298067
Argentina,ARG,2011,34717,243934,2570,5040,12482,3694,302437
Argentina,ARG,2012,35734,245897,2508,4723,12665,3885,305412
Argentina,ARG,2013,37334,248464,2468,4665,12839,3979,309749
Argentina,ARG,2014,38451,249921,2421,4611,12583,4085,312072
Argentina,ARG,2015,39899,256087,2452,4229,12408,4030,319105
Argentina,ARG,2016,42067,266917,2527,3992,12592,4062,332157
Argentina,ARG,2017,41454,271627,2577,3816,12665,4073,336212
Argentina,ARG,2018,40267,270545,2553,3712,12644,4086,333807
Argentina,ARG,2019,40014,274114,2585,3649,12585,4105,337052
Armenia,ARM,1990,1674,18092,80,1186,1206,563,22801
Armenia,ARM,1991,1554,19140,82,1082,1199,614,23671
Armenia,ARM,1992,1507,21171,93,999,1295,652,25717
Armenia,ARM,1993,1414,22146,97,939,1323,793,26712
Armenia,ARM,1994,1294,21205,92,873,1295,761,25520
Armenia,ARM,1995,1159,21211,85,801,1089,678,25023
Armenia,ARM,1996,1048,21573,80,740,984,608,25033
Armenia,ARM,1997,942,20973,74,684,907,540,24120
Armenia,ARM,1998,857,20994,71,618,826,518,23884
Armenia,ARM,1999,805,21292,68,559,752,498,23974
Armenia,ARM,2000,743,21393,62,520,709,438,23865
Armenia,ARM,2001,707,22121,55,485,700,415,24483
Armenia,ARM,2002,690,22702,46,452,671,406,24967
Armenia,ARM,2003,687,23454,36,437,653,375,25642
Armenia,ARM,2004,706,23568,22,422,632,394,25744
Armenia,ARM,2005,738,24205,15,405,637,406,26406
Armenia,ARM,2006,794,24845,10,387,648,424,27108
Armenia,ARM,2007,785,24815,8,357,648,446,27059
Armenia,ARM,2008,792,25366,7,349,653,413,27580
Armenia,ARM,2009,774,25396,7,333,654,394,27558
Armenia,ARM,2010,753,25582,7,309,659,377,27687
Armenia,ARM,2011,736,25662,6,292,672,356,27724
Armenia,ARM,2012,723,25503,5,265,680,370,27546
Armenia,ARM,2013,701,25006,4,247,657,334,26949
Armenia,ARM,2014,708,25123,4,233,652,340,27060
Armenia,ARM,2015,732,25797,5,219,672,355,27780
Armenia,ARM,2016,739,25757,5,219,652,419,27791
Armenia,ARM,2017,701,26023,5,195,632,295,27851
Armenia,ARM,2018,680,26169,5,178,624,299,27955
Armenia,ARM,2019,658,26224,5,164,616,297,27964
Australia,AUS,1990,2444,103394,124,891,5539,1197,113589
Australia,AUS,1991,2501,103482,128,826,5376,1208,113521
Australia,AUS,1992,2624,105459,136,830,5251,1230,115530
Australia,AUS,1993,2737,106260,147,766,5091,1308,116309
Australia,AUS,1994,2852,108780,161,743,5171,1411,119118
Australia,AUS,1995,2911,109234,169,717,5168,1485,119684
Australia,AUS,1996,3070,110845,179,702,5231,1548,121575
Australia,AUS,1997,3131,110914,187,684,5261,1640,121817
Australia,AUS,1998,2993,110773,200,664,5243,1744,121617
Australia,AUS,1999,3047,110804,211,700,5162,1782,121706
Australia,AUS,2000,3251,111389,218,668,5023,1741,122290
Australia,AUS,2001,3345,112251,222,657,4834,1625,122934
Australia,AUS,2002,3494,114043,234,649,4765,1592,124777
Australia,AUS,2003,3583,113915,238,633,4679,1605,124653
Australia,AUS,2004,3533,113957,245,636,4543,1569,124483
Australia,AUS,2005,3377,114074,243,665,4478,1604,124441
Australia,AUS,2006,3346,115661,243,676,4444,1654,126024
Australia,AUS,2007,3321,118882,245,666,4540,1634,129288
Australia,AUS,2008,3221,121329,246,660,4621,1638,131715
Australia,AUS,2009,3212,121501,244,667,4800,1662,132086
Australia,AUS,2010,3312,122294,249,657,4651,1636,132799
Australia,AUS,2011,3494,124507,248,627,4661,1658,135195
Australia,AUS,2012,3608,125091,247,594,4589,1681,135810
Australia,AUS,2013,3716,126569,244,583,4591,1716,137419
Australia,AUS,2014,3947,130020,257,550,4733,1831,141338
Australia,AUS,2015,4186,133536,265,554,4869,1903,145313
Australia,AUS,2016,4353,134895,275,543,4779,1944,146789
Australia,AUS,2017,4444,138497,281,524,4726,2005,150477
Australia,AUS,2018,4602,144130,291,509,4763,2069,156364
Australia,AUS,2019,4719,148454,300,500,4802,2120,160895
Austria,AUT,1990,1683,74428,13,324,3462,451,80361
Austria,AUT,1991,1647,74594,11,324,3434,464,80474
Austria,AUT,1992,1642,74467,10,317,3332,496,80264
Austria,AUT,1993,1566,74054,9,286,3293,508,79716
Austria,AUT,1994,1516,73153,8,270,3218,522,78687
Austria,AUT,1995,1450,73474,7,236,3103,543,78813
Austria,AUT,1996,1409,73453,7,219,2960,551,78599
Austria,AUT,1997,1343,72472,6,198,2827,540,77386
Austria,AUT,1998,1353,71968,6,190,2713,557,76787
Austria,AUT,1999,1372,71505,5,178,2722,559,76341
Austria,AUT,2000,1356,70903,5,182,2644,584,75674
Austria,AUT,2001,1325,69631,5,185,2543,602,74291
Austria,AUT,2002,1337,70002,6,175,2524,617,74661
Austria,AUT,2003,1376,69988,7,185,2482,655,74693
Austria,AUT,2004,1358,68646,7,180,2396,679,73266
Austria,AUT,2005,1379,68713,8,171,2361,703,73335
Austria,AUT,2006,1317,67825,8,158,2267,736,72311
Austria,AUT,2007,1306,67970,9,152,2221,760,72418
Austria,AUT,2008,1255,67892,9,150,2207,782,72295
Austria,AUT,2009,1226,68823,9,150,2196,813,73217
Austria,AUT,2010,1209,69133,11,151,2182,806,73492
Austria,AUT,2011,1191,69812,11,142,2122,816,74094
Austria,AUT,2012,1191,71063,12,130,2110,821,75327
Austria,AUT,2013,1211,71636,11,128,2082,811,75879
Austria,AUT,2014,1228,72221,12,131,2056,809,76457
Austria,AUT,2015,1306,73805,12,132,2087,823,78165
Austria,AUT,2016,1351,73758,13,136,2049,816,78123
Austria,AUT,2017,1426,73378,14,132,2025,802,77777
Austria,AUT,2018,1420,73979,14,123,2010,793,78339
Austria,AUT,2019,1449,75257,14,118,2018,793,79649
Azerbaijan,AZE,1990,11382,38017,295,3162,2456,1192,56504
Azerbaijan,AZE,1991,11213,39968,284,3061,2593,1605,58724
Azerbaijan,AZE,1992,11169,42895,280,2938,3014,4648,64944
Azerbaijan,AZE,1993,10941,45528,265,2836,3184,3793,66547
Azerbaijan,AZE,1994,10708,47683,254,2775,3010,4211,68641
Azerbaijan,AZE,1995,10112,47108,230,2714,2502,2211,64877
Azerbaijan,AZE,1996,9548,46695,211,2685,2198,1753,63090
Azerbaijan,AZE,1997,9104,46233,195,2677,2069,1528,61806
Azerbaijan,AZE,1998,8752,46552,179,2702,1964,1338,61487
Azerbaijan,AZE,1999,8333,47249,158,2753,1882,1155,61530
Azerbaijan,AZE,2000,7799,47842,136,2803,1869,1013,61462
Azerbaijan,AZE,2001,7161,48448,117,2805,1769,922,61222
Azerbaijan,AZE,2002,6743,49881,106,2893,1764,864,62251
Azerbaijan,AZE,2003,6499,52060,99,3038,1800,852,64348
Azerbaijan,AZE,2004,6275,53578,93,3163,1836,832,65777
Azerbaijan,AZE,2005,6013,55390,88,3207,1906,842,67446
Azerbaijan,AZE,2006,5615,56506,79,3254,1889,785,68128
Azerbaijan,AZE,2007,5182,56884,71,3244,1883,744,68008
Azerbaijan,AZE,2008,4994,58086,68,3199,1899,791,69037
Azerbaijan,AZE,2009,4820,59221,64,3131,1901,778,69915
Azerbaijan,AZE,2010,4713,60231,62,3078,1931,811,70826
Azerbaijan,AZE,2011,4571,61580,59,2989,1924,822,71945
Azerbaijan,AZE,2012,4407,62630,57,2877,1899,834,72704
Azerbaijan,AZE,2013,4236,63628,55,2757,1905,830,73411
Azerbaijan,AZE,2014,4093,65008,55,2608,1890,869,74523
Azerbaijan,AZE,2015,3931,65530,51,2471,1903,881,74767
Azerbaijan,AZE,2016,3773,67009,50,2307,1858,952,75949
Azerbaijan,AZE,2017,3616,68319,49,2132,1868,859,76843
Azerbaijan,AZE,2018,3450,67347,47,1987,1917,855,75603
Azerbaijan,AZE,2019,3327,67935,47,1857,1907,850,75923
Bahamas,BHS,1990,152,982,13,57,96,55,1355
Bahamas,BHS,1991,175,994,13,59,99,49,1389
Bahamas,BHS,1992,204,1008,13,61,105,56,1447
Bahamas,BHS,1993,248,1038,13,58,103,65,1525
Bahamas,BHS,1994,278,1067,13,54,104,76,1592
Bahamas,BHS,1995,284,1091,13,51,106,68,1613
Bahamas,BHS,1996,325,1143,13,50,107,68,1706
Bahamas,BHS,1997,288,1144,12,48,110,71,1673
Bahamas,BHS,1998,278,1172,11,44,111,74,1690
Bahamas,BHS,1999,354,1226,11,41,114,74,1820
Bahamas,BHS,2000,345,1220,11,37,113,79,1805
Bahamas,BHS,2001,352,1270,11,36,116,70,1855
Bahamas,BHS,2002,314,1272,10,37,119,71,1823
Bahamas,BHS,2003,293,1303,10,37,87,78,1808
Bahamas,BHS,2004,291,1328,10,38,101,76,1844
Bahamas,BHS,2005,251,1307,9,37,90,92,1786
Bahamas,BHS,2006,270,1357,9,37,92,95,1860
Bahamas,BHS,2007,228,1364,9,37,92,104,1834
Bahamas,BHS,2008,224,1425,9,36,94,113,1901
Bahamas,BHS,2009,226,1509,9,35,97,119,1995
Bahamas,BHS,2010,216,1551,9,33,100,127,2036
Bahamas,BHS,2011,215,1592,9,33,98,142,2089
Bahamas,BHS,2012,218,1621,9,32,100,146,2126
Bahamas,BHS,2013,213,1654,9,31,99,148,2154
Bahamas,BHS,2014,219,1707,9,29,101,142,2207
Bahamas,BHS,2015,222,1777,9,28,135,140,2311
Bahamas,BHS,2016,222,1834,9,27,102,137,2331
Bahamas,BHS,2017,222,1887,9,26,102,137,2383
Bahamas,BHS,2018,223,1950,9,26,102,135,2445
Bahamas,BHS,2019,224,2017,11,25,152,133,2562
Bahrain,BHR,2007,106,2122,8,61,277,39,2613
Bahrain,BHR,2008,107,2175,8,60,285,43,2678
Bahrain,BHR,2009,106,2231,8,59,285,44,2733
Bahrain,BHR,2010,105,2290,8,57,279,45,2784
Bahrain,BHR,1990,68,1376,6,148,157,15,1770
Bahrain,BHR,1991,69,1431,6,146,166,18,1836
Bahrain,BHR,1992,69,1462,6,138,168,17,1860
Bahrain,BHR,1993,69,1470,6,128,172,18,1863
Bahrain,BHR,1994,68,1498,6,115,178,19,1884
Bahrain,BHR,1995,68,1546,6,99,184,19,1922
Bahrain,BHR,1996,69,1600,7,84,189,26,1975
Bahrain,BHR,1997,67,1635,8,75,197,24,2006
Bahrain,BHR,1998,70,1677,8,70,204,21,2050
Bahrain,BHR,1999,74,1719,8,67,214,23,2105
Bahrain,BHR,2000,74,1621,7,65,228,25,2020
Bahrain,BHR,2001,72,1530,6,65,229,26,1928
Bahrain,BHR,2002,79,1731,8,63,227,27,2135
Bahrain,BHR,2003,90,1931,8,62,238,29,2358
Bahrain,BHR,2004,97,2011,8,64,255,32,2467
Bahrain,BHR,2005,102,2068,8,64,268,36,2546
Bahrain,BHR,2006,103,2093,8,63,275,38,2580
Bahrain,BHR,2011,105,2349,8,56,279,45,2842
Bahrain,BHR,2012,104,2400,7,58,292,49,2910
Bahrain,BHR,2013,103,2453,6,58,302,47,2969
Bahrain,BHR,2014,103,2540,6,59,294,52,3054
Bahrain,BHR,2015,105,2694,6,57,295,51,3208
Bahrain,BHR,2016,109,2878,6,51,286,44,3374
Bahrain,BHR,2017,114,3103,7,47,284,54,3609
Bahrain,BHR,2018,118,3311,7,42,282,40,3800
Bahrain,BHR,2019,119,3578,7,38,281,39,4062
Bangladesh,BGD,2007,149303,469756,21270,94721,46329,4598,785977
Bangladesh,BGD,2008,143807,472552,18821,90519,39297,4477,769473
Bangladesh,BGD,2009,134013,483064,16744,86136,38068,4689,762714
Bangladesh,BGD,2010,129672,496905,14942,82386,36061,4865,764831
Bangladesh,BGD,2011,121273,480830,13015,79040,32950,5211,732319
Bangladesh,BGD,2012,110388,472463,11342,75114,30677,5046,705030
Bangladesh,BGD,2013,108071,485520,10283,70701,28835,5107,708517
Bangladesh,BGD,2015,107186,524725,9181,62690,26900,5381,736063
Bangladesh,BGD,2016,107235,546914,8420,58750,26163,5459,752941
Bangladesh,BGD,1990,359135,353324,126019,163109,56447,5042,1063076
Bangladesh,BGD,1991,345872,332243,112511,157703,193632,5100,1147061
Bangladesh,BGD,1992,326682,336752,104141,153351,54848,5436,981210
Bangladesh,BGD,1993,311313,337803,94613,147786,55596,5183,952294
Bangladesh,BGD,1994,293954,339437,89793,142337,55337,5328,926186
Bangladesh,BGD,1995,279159,348534,83482,138615,57655,5483,912928
Bangladesh,BGD,1996,260106,348610,77089,134317,57046,5667,882835
Bangladesh,BGD,1997,247732,348097,70332,130110,55993,5182,857446
Bangladesh,BGD,1998,234827,353143,63848,124977,55341,5034,837170
Bangladesh,BGD,1999,223233,361495,58299,120162,52406,4724,820319
Bangladesh,BGD,2000,207522,377333,53943,116518,51976,4741,812033
Bangladesh,BGD,2001,197778,383833,48529,113021,50108,4568,797837
Bangladesh,BGD,2002,189974,398896,43032,111055,47540,4672,795169
Bangladesh,BGD,2003,183572,413363,37266,108590,45054,4671,792516
Bangladesh,BGD,2004,175071,423698,32096,105624,43603,4322,784414
Bangladesh,BGD,2005,164166,441926,27260,102468,41995,4427,782242
Bangladesh,BGD,2006,154735,460951,23556,98685,40897,4563,783387
Bangladesh,BGD,2014,109654,511921,9608,66581,27915,5444,731123
Bangladesh,BGD,2017,109632,588807,7955,54317,26061,5386,792158
Bangladesh,BGD,2018,107524,612466,7220,50247,25314,5339,808110
Bangladesh,BGD,2019,106544,635621,6684,46773,25097,5404,826123
Barbados,BRB,1990,148,1816,20,45,67,31,2127
Barbados,BRB,1991,140,1808,20,43,67,31,2109
Barbados,BRB,1992,149,1866,20,40,67,38,2180
Barbados,BRB,1993,158,1897,19,37,70,39,2220
Barbados,BRB,1994,175,1916,19,36,70,35,2251
Barbados,BRB,1995,180,1916,19,36,71,35,2257
Barbados,BRB,1996,177,1909,18,36,71,35,2246
Barbados,BRB,1997,182,1915,17,36,71,34,2255
Barbados,BRB,1998,188,1888,17,36,68,29,2226
Barbados,BRB,1999,191,1842,15,36,68,31,2183
Barbados,BRB,2000,209,1859,15,35,64,36,2218
Barbados,BRB,2001,205,1827,14,34,59,34,2173
Barbados,BRB,2002,203,1891,14,34,59,36,2237
Barbados,BRB,2003,200,1950,14,34,63,39,2300
Barbados,BRB,2004,203,1968,14,32,61,41,2319
Barbados,BRB,2005,200,1924,13,32,59,42,2270
Barbados,BRB,2006,195,1938,13,31,57,43,2277
Barbados,BRB,2007,191,1951,13,30,56,40,2281
Barbados,BRB,2008,184,1952,12,29,54,42,2273
Barbados,BRB,2009,176,1930,12,29,55,36,2238
Barbados,BRB,2010,176,1962,12,28,55,38,2271
Barbados,BRB,2011,177,1996,10,27,56,41,2307
Barbados,BRB,2012,176,2018,10,25,55,40,2324
Barbados,BRB,2013,175,2073,10,25,56,41,2380
Barbados,BRB,2014,179,2134,10,24,56,39,2442
Barbados,BRB,2015,182,2187,11,24,56,40,2500
Barbados,BRB,2016,185,2242,12,23,58,40,2560
Barbados,BRB,2017,188,2304,12,23,59,40,2626
Barbados,BRB,2018,192,2385,12,22,59,40,2710
Barbados,BRB,2019,199,2516,13,22,61,42,2853
Belarus,BLR,2007,2543,115157,74,362,7535,5528,131199
Belarus,BLR,2008,2533,115524,70,345,7342,5675,131489
Belarus,BLR,2009,2601,117092,71,330,7101,5742,132937
Belarus,BLR,2010,2604,118653,77,308,6989,5917,134548
Belarus,BLR,2011,2623,120968,81,295,6889,6224,137080
Belarus,BLR,2012,2242,110271,76,281,5766,5452,124088
Belarus,BLR,2014,1991,109390,81,255,5131,5308,122156
Belarus,BLR,2016,1871,108788,72,223,4672,5040,120666
Belarus,BLR,1990,2002,93009,114,888,6644,3550,106207
Belarus,BLR,1991,2010,96655,112,858,7112,3783,110530
Belarus,BLR,1992,2023,99669,110,791,7565,4267,114425
Belarus,BLR,1993,2172,108438,116,708,8275,4900,124609
Belarus,BLR,1994,2233,109722,111,669,8547,5149,126431
Belarus,BLR,1995,2350,112883,114,609,9047,5564,130567
Belarus,BLR,1996,2343,112110,108,549,9020,5497,129627
Belarus,BLR,1997,2427,113843,107,529,9250,5805,131961
Belarus,BLR,1998,2528,115663,105,527,9665,6061,134549
Belarus,BLR,1999,2692,118816,107,494,9992,6159,138260
Belarus,BLR,2000,2494,113397,99,460,9243,6012,131705
Belarus,BLR,2001,2578,118640,100,415,9485,6211,137429
Belarus,BLR,2002,2758,124521,89,388,9521,6584,143861
Belarus,BLR,2003,2720,121636,81,372,9080,6309,140198
Belarus,BLR,2004,2654,119951,82,359,8732,6145,137923
Belarus,BLR,2005,2746,122506,83,359,8820,6169,140683
Belarus,BLR,2006,2668,119647,79,361,8260,5896,136911
Belarus,BLR,2013,2086,109972,81,271,5396,5404,123210
Belarus,BLR,2015,1908,108020,75,235,4806,5149,120193
Belarus,BLR,2017,1860,109817,72,206,4684,5041,121680
Belarus,BLR,2018,1835,108480,71,188,4697,4968,120239
Belarus,BLR,2019,1828,109078,69,173,4647,4952,120747
Belgium,BEL,1990,3927,90063,108,437,4563,649,99747
Belgium,BEL,1991,3979,89358,120,432,4499,697,99085
Belgium,BEL,1992,4058,89778,157,418,4507,691,99609
Belgium,BEL,1993,4271,90321,177,391,4515,732,100407
Belgium,BEL,1994,4375,89736,196,360,4537,749,99953
Belgium,BEL,1995,4612,89909,210,320,4449,747,100247
Belgium,BEL,1996,4835,89522,204,286,4339,762,99948
Belgium,BEL,1997,4996,89031,235,286,4299,765,99612
Belgium,BEL,1998,5266,88854,241,272,4258,803,99694
Belgium,BEL,1999,5536,88564,283,260,4247,841,99731
Belgium,BEL,2000,5830,88130,340,258,4281,813,99652
Belgium,BEL,2001,5903,87403,378,251,4194,830,98959
Belgium,BEL,2002,6133,87962,419,234,4066,835,99649
Belgium,BEL,2003,6290,87611,454,233,3941,843,99372
Belgium,BEL,2004,6185,85896,470,220,3787,828,97386
Belgium,BEL,2005,6290,85725,495,231,3735,843,97319
Belgium,BEL,2006,6198,84652,508,237,3681,916,96192
Belgium,BEL,2007,6247,85180,531,239,3707,879,96783
Belgium,BEL,2008,6398,85847,557,230,3762,904,97698
Belgium,BEL,2009,6355,86653,569,226,3692,920,98415
Belgium,BEL,2010,6337,87170,589,229,3641,926,98892
Belgium,BEL,2011,6371,87956,607,225,3614,954,99727
Belgium,BEL,2012,6542,89667,633,228,3542,974,101586
Belgium,BEL,2013,6658,90171,647,216,3460,964,102116
Belgium,BEL,2014,6588,89066,653,209,3356,977,100849
Belgium,BEL,2015,6933,90887,683,201,3334,994,103032
Belgium,BEL,2016,6963,90623,673,193,3288,1055,102795
Belgium,BEL,2017,7100,92009,685,187,3312,987,104280
Belgium,BEL,2018,7269,93604,698,181,3319,993,106064
Belgium,BEL,2019,7426,95328,709,176,3306,997,107942
Belize,BLZ,1990,149,490,36,92,60,29,856
Belize,BLZ,1991,135,480,35,89,69,44,852
Belize,BLZ,1992,135,488,33,86,72,27,841
Belize,BLZ,1993,141,504,31,84,71,32,863
Belize,BLZ,1994,147,527,29,80,72,42,897
Belize,BLZ,1995,144,566,29,78,85,33,935
Belize,BLZ,1996,156,618,29,78,91,32,1004
Belize,BLZ,1997,158,680,29,79,98,41,1085
Belize,BLZ,1998,167,730,28,79,111,51,1166
Belize,BLZ,1999,184,773,27,79,103,50,1216
Belize,BLZ,2000,193,801,27,79,117,54,1271
Belize,BLZ,2001,180,768,25,79,134,61,1247
Belize,BLZ,2002,191,753,25,79,104,70,1222
Belize,BLZ,2003,194,765,23,77,101,67,1227
Belize,BLZ,2004,200,791,23,76,101,65,1256
Belize,BLZ,2005,183,805,23,75,104,74,1264
Belize,BLZ,2006,185,833,21,75,99,76,1289
Belize,BLZ,2007,178,845,21,73,100,76,1293
Belize,BLZ,2008,170,844,21,72,108,83,1298
Belize,BLZ,2009,182,879,21,71,99,96,1348
Belize,BLZ,2010,188,923,21,71,103,105,1411
Belize,BLZ,2011,188,950,19,71,107,107,1442
Belize,BLZ,2012,186,966,19,68,107,110,1456
Belize,BLZ,2013,191,1009,19,67,111,108,1505
Belize,BLZ,2014,208,1067,21,65,114,105,1580
Belize,BLZ,2015,220,1117,23,66,119,111,1656
Belize,BLZ,2016,209,1156,23,66,125,121,1700
Belize,BLZ,2017,210,1201,23,63,131,123,1751
Belize,BLZ,2018,216,1276,25,62,134,125,1838
Belize,BLZ,2019,220,1331,25,62,138,127,1903
Benin,BEN,1990,26743,14151,5123,9344,1867,465,57693
Benin,BEN,1991,27386,14414,5016,9471,1943,482,58712
Benin,BEN,1992,27422,14665,4889,9587,1958,505,59026
Benin,BEN,1993,27759,14933,4732,9668,2010,529,59631
Benin,BEN,1994,28551,15342,4588,9793,2080,556,60910
Benin,BEN,1995,28966,15737,4407,9957,2179,583,61829
Benin,BEN,1996,29862,16172,4212,10100,2211,608,63165
Benin,BEN,1997,30484,16458,3996,10262,2261,637,64098
Benin,BEN,1998,31275,16808,3781,10418,2295,665,65242
Benin,BEN,1999,31910,17137,3578,10613,2370,686,66294
Benin,BEN,2000,32918,17609,3281,10843,2403,712,67766
Benin,BEN,2001,34196,17853,2858,11014,2413,730,69064
Benin,BEN,2002,35495,18336,2714,11182,2523,756,71006
Benin,BEN,2003,36584,18600,2494,11343,2560,772,72353
Benin,BEN,2004,38502,18966,2414,11548,2623,797,74850
Benin,BEN,2005,39041,19263,2287,11794,2628,813,75826
Benin,BEN,2006,39575,19742,2207,12020,2659,832,77035
Benin,BEN,2007,39703,20072,2116,12293,2714,855,77753
Benin,BEN,2008,38360,20739,2068,12609,2781,887,77444
Benin,BEN,2009,36885,21510,2065,12987,2867,933,77247
Benin,BEN,2010,36254,22230,2080,13340,3012,980,77896
Benin,BEN,2011,35198,23012,2076,13686,3037,1021,78030
Benin,BEN,2012,35924,23652,2096,13882,3142,1061,79757
Benin,BEN,2013,36250,24255,2043,13984,3115,1096,80743
Benin,BEN,2014,36021,24743,1952,14036,3147,1127,81026
Benin,BEN,2015,36982,25440,1981,14086,3284,1170,82943
Benin,BEN,2016,37012,26030,1936,14139,3356,1219,83692
Benin,BEN,2017,36048,26818,1860,14201,3412,1250,83589
Benin,BEN,2018,35614,27226,1694,14046,3357,1255,83192
Benin,BEN,2019,34382,27964,1603,13929,3375,1278,82531
Bermuda,BMU,1990,29,420,1,4,21,4,479
Bermuda,BMU,1991,24,415,1,4,21,5,470
Bermuda,BMU,1992,26,402,1,4,20,5,458
Bermuda,BMU,1993,31,404,1,4,19,5,464
Bermuda,BMU,1994,31,402,1,3,17,6,460
Bermuda,BMU,1995,25,390,1,3,17,4,440
Bermuda,BMU,1996,33,399,0,3,16,4,455
Bermuda,BMU,1997,27,386,0,2,16,4,435
Bermuda,BMU,1998,27,381,0,2,16,5,431
Bermuda,BMU,1999,27,383,0,2,14,5,431
Bermuda,BMU,2000,31,386,0,2,16,5,440
Bermuda,BMU,2001,28,379,0,2,13,5,427
Bermuda,BMU,2002,28,378,0,2,13,5,426
Bermuda,BMU,2003,27,377,0,2,17,4,427
Bermuda,BMU,2004,24,377,0,2,13,4,420
Bermuda,BMU,2005,22,380,0,2,13,4,421
Bermuda,BMU,2006,22,387,0,2,12,4,427
Bermuda,BMU,2007,21,390,0,2,12,4,429
Bermuda,BMU,2008,22,395,0,2,12,4,435
Bermuda,BMU,2009,21,401,0,2,12,4,440
Bermuda,BMU,2010,21,407,0,2,12,5,447
Bermuda,BMU,2011,21,416,0,2,12,4,455
Bermuda,BMU,2012,21,426,0,2,12,4,465
Bermuda,BMU,2013,22,440,0,1,12,4,479
Bermuda,BMU,2014,23,452,0,1,12,4,492
Bermuda,BMU,2015,24,465,0,1,12,4,506
Bermuda,BMU,2016,23,477,0,1,12,4,517
Bermuda,BMU,2017,24,490,0,1,12,4,531
Bermuda,BMU,2018,23,506,0,1,12,4,546
Bermuda,BMU,2019,24,516,0,1,12,4,557
Bhutan,BTN,1990,2027,1534,146,1014,164,21,4906
Bhutan,BTN,1991,1861,1568,137,928,159,20,4673
Bhutan,BTN,1992,1685,1595,120,859,154,20,4433
Bhutan,BTN,1993,1532,1637,106,823,153,20,4271
Bhutan,BTN,1994,1436,1681,96,799,191,19,4222
Bhutan,BTN,1995,1321,1728,89,781,154,20,4093
Bhutan,BTN,1996,1280,1759,85,765,153,21,4063
Bhutan,BTN,1997,1269,1822,84,752,160,25,4112
Bhutan,BTN,1998,1175,1882,79,736,162,24,4058
Bhutan,BTN,1999,1151,1900,64,709,152,21,3997
Bhutan,BTN,2000,1001,1982,62,687,359,24,4115
Bhutan,BTN,2001,976,2022,55,659,155,23,3890
Bhutan,BTN,2002,922,2056,47,630,149,21,3825
Bhutan,BTN,2003,829,2118,43,602,149,20,3761
Bhutan,BTN,2004,763,2166,38,573,146,19,3705
Bhutan,BTN,2005,711,2217,32,544,142,19,3665
Bhutan,BTN,2006,644,2264,25,518,136,23,3610
Bhutan,BTN,2007,656,2337,29,499,142,19,3682
Bhutan,BTN,2008,622,2403,26,481,143,25,3700
Bhutan,BTN,2009,604,2475,23,462,166,21,3751
Bhutan,BTN,2010,571,2541,21,442,143,21,3739
Bhutan,BTN,2011,548,2607,19,423,145,22,3764
Bhutan,BTN,2012,526,2669,17,403,143,21,3779
Bhutan,BTN,2013,514,2732,16,384,143,21,3810
Bhutan,BTN,2014,506,2797,14,364,142,21,3844
Bhutan,BTN,2015,495,2864,14,344,139,20,3876
Bhutan,BTN,2016,482,2927,12,323,140,21,3905
Bhutan,BTN,2017,472,2991,12,300,137,21,3933
Bhutan,BTN,2018,460,3059,11,279,137,21,3967
Bhutan,BTN,2019,450,3124,10,261,134,20,3999
Bolivia,BOL,1990,18626,23537,4035,7209,3304,867,57578
Bolivia,BOL,1991,18307,24057,3948,7148,3327,883,57670
Bolivia,BOL,1992,17713,24664,3850,7087,3396,895,57605
Bolivia,BOL,1993,17062,25319,3716,6995,3357,908,57357
Bolivia,BOL,1994,16297,25784,3596,6897,3357,923,56854
Bolivia,BOL,1995,15841,26457,3487,6783,3370,938,56876
Bolivia,BOL,1996,15372,26935,3365,6666,3413,946,56697
Bolivia,BOL,1997,14700,27946,3263,6585,3503,970,56967
Bolivia,BOL,1998,14164,28652,3128,6439,3610,980,56973
Bolivia,BOL,1999,13803,29377,2980,6325,3456,986,56927
Bolivia,BOL,2000,13254,30160,2856,6204,3498,1048,57020
Bolivia,BOL,2001,12718,30858,2688,6067,3466,998,56795
Bolivia,BOL,2002,12260,31705,2534,5948,3493,994,56934
Bolivia,BOL,2003,11803,32530,2394,5839,3455,992,57013
Bolivia,BOL,2004,11416,33335,2278,5764,3332,998,57123
Bolivia,BOL,2005,11173,34313,2175,5713,3245,997,57616
Bolivia,BOL,2006,10903,35349,2092,5621,3251,1001,58217
Bolivia,BOL,2007,10702,36563,2045,5601,3323,1018,59252
Bolivia,BOL,2008,10563,37780,1993,5559,3326,1033,60254
Bolivia,BOL,2009,10465,39042,1944,5503,3292,1050,61296
Bolivia,BOL,2010,10391,40336,1910,5453,3323,1080,62493
Bolivia,BOL,2011,10334,41780,1876,5395,3362,1079,63826
Bolivia,BOL,2012,10302,43115,1845,5319,3335,1086,65002
Bolivia,BOL,2013,10316,44449,1820,5248,3396,1111,66340
Bolivia,BOL,2014,10380,45637,1792,5128,3433,1114,67484
Bolivia,BOL,2015,10203,47026,1772,5006,3384,1118,68509
Bolivia,BOL,2016,9877,48614,1766,4879,3401,1114,69651
Bolivia,BOL,2017,9837,49920,1743,4767,3425,1123,70815
Bolivia,BOL,2018,9748,51450,1719,4544,3406,1127,71994
Bolivia,BOL,2019,9693,52853,1704,4366,3476,1130,73222
Bosnia and Herzegovina,BIH,1990,898,24471,3,732,907,1213,28224
Bosnia and Herzegovina,BIH,1991,955,26892,3,676,1052,1300,30878
Bosnia and Herzegovina,BIH,1992,956,27219,3,635,1031,8446,38290
Bosnia and Herzegovina,BIH,1993,961,27710,3,572,960,6532,36738
Bosnia and Herzegovina,BIH,1994,957,28042,3,506,922,3824,34254
Bosnia and Herzegovina,BIH,1995,945,28195,3,438,870,10391,40842
Bosnia and Herzegovina,BIH,1996,889,28024,3,387,826,588,30717
Bosnia and Herzegovina,BIH,1997,828,28051,3,355,813,554,30604
Bosnia and Herzegovina,BIH,1998,732,26737,3,318,772,502,29064
Bosnia and Herzegovina,BIH,1999,681,26734,3,281,756,462,28917
Bosnia and Herzegovina,BIH,2000,660,27531,3,264,773,429,29660
Bosnia and Herzegovina,BIH,2001,661,29335,3,219,789,382,31389
Bosnia and Herzegovina,BIH,2002,655,30549,4,228,810,351,32597
Bosnia and Herzegovina,BIH,2003,625,31010,5,191,802,323,32956
Bosnia and Herzegovina,BIH,2004,604,31133,6,171,801,301,33016
Bosnia and Herzegovina,BIH,2005,608,32180,7,160,850,294,34099
Bosnia and Herzegovina,BIH,2006,580,31913,7,156,824,282,33762
Bosnia and Herzegovina,BIH,2007,590,33307,8,147,871,287,35210
Bosnia and Herzegovina,BIH,2008,549,31893,7,143,809,267,33668
Bosnia and Herzegovina,BIH,2009,540,32140,8,135,784,256,33863
Bosnia and Herzegovina,BIH,2010,530,32335,8,130,759,247,34009
Bosnia and Herzegovina,BIH,2011,533,32916,9,114,739,239,34550
Bosnia and Herzegovina,BIH,2012,526,32905,8,104,723,234,34500
Bosnia and Herzegovina,BIH,2013,530,33401,8,102,730,228,34999
Bosnia and Herzegovina,BIH,2014,535,33970,8,93,754,222,35582
Bosnia and Herzegovina,BIH,2015,559,35127,7,101,720,230,36744
Bosnia and Herzegovina,BIH,2016,558,34927,7,100,695,223,36510
Bosnia and Herzegovina,BIH,2017,556,35060,7,87,679,218,36607
Bosnia and Herzegovina,BIH,2018,559,35467,7,81,671,216,37001
Bosnia and Herzegovina,BIH,2019,556,35698,7,75,662,212,37210
Botswana,BWA,2007,13260,6860,396,1087,1119,545,23267
Botswana,BWA,2008,12325,7017,394,1080,1124,553,22493
Botswana,BWA,2009,11255,7143,392,1069,1124,561,21544
Botswana,BWA,2010,10661,7331,406,1066,1152,566,21182
Botswana,BWA,2012,9794,7676,401,1034,1153,567,20625
Botswana,BWA,2013,9343,7854,396,1008,1165,564,20330
Botswana,BWA,2016,8695,8387,380,944,1145,561,20112
Botswana,BWA,1990,3925,4086,346,871,550,85,9863
Botswana,BWA,1991,4612,4313,340,882,590,82,10819
Botswana,BWA,1992,5593,4585,338,897,646,90,12149
Botswana,BWA,1993,6961,4866,320,917,705,98,13867
Botswana,BWA,1994,8552,5202,309,935,776,110,15884
Botswana,BWA,1995,10363,5535,301,950,866,123,18138
Botswana,BWA,1996,12341,5820,292,960,902,141,20456
Botswana,BWA,1997,14315,6071,287,971,955,169,22768
Botswana,BWA,1998,16298,6372,315,996,1024,221,25226
Botswana,BWA,1999,18080,6636,324,1017,1065,297,27419
Botswana,BWA,2000,19621,6919,331,1043,1109,379,29402
Botswana,BWA,2001,20772,7132,341,1064,1137,446,30892
Botswana,BWA,2002,21252,7283,349,1085,1160,500,31629
Botswana,BWA,2003,20568,7282,339,1101,1142,544,30976
Botswana,BWA,2004,18518,7144,330,1106,1128,546,28772
Botswana,BWA,2005,16077,6958,340,1091,1107,553,26126
Botswana,BWA,2006,14817,6922,378,1084,1123,547,24871
Botswana,BWA,2011,10252,7532,402,1058,1157,566,20967
Botswana,BWA,2014,9077,8054,398,985,1156,561,20231
Botswana,BWA,2015,8902,8235,394,965,1153,565,20214
Botswana,BWA,2017,8742,8646,380,925,1162,562,20417
Botswana,BWA,2018,8716,8905,374,910,1176,565,20646
Botswana,BWA,2019,8618,9146,366,901,1179,564,20774
Brazil,BRA,1990,141229,555800,32172,85893,67019,49263,931376
Brazil,BRA,1991,136784,556443,30450,81958,65578,49180,920393
Brazil,BRA,1992,133960,569729,29266,78302,64769,48496,924522
Brazil,BRA,1993,133105,595381,28326,75325,65228,51781,949146
Brazil,BRA,1994,130856,605471,27223,72921,65530,53603,955604
Brazil,BRA,1995,127555,615778,26311,70669,66163,57372,963848
Brazil,BRA,1996,121858,631280,25918,69437,66704,58281,973478
Brazil,BRA,1997,113613,638381,25534,68262,65994,59951,971735
Brazil,BRA,1998,109329,656585,25433,67253,64947,62500,986047
Brazil,BRA,1999,105298,670672,25114,66460,64381,62515,994440
Brazil,BRA,2000,101923,681915,24466,65546,63938,65194,1002982
Brazil,BRA,2001,99679,696319,24229,64437,64187,67603,1016454
Brazil,BRA,2002,98775,712822,23590,63168,65072,69815,1033242
Brazil,BRA,2003,98953,730552,22987,61802,65489,70194,1049977
Brazil,BRA,2004,98595,747696,21961,60517,66474,69130,1064373
Brazil,BRA,2005,97674,749849,20574,59076,66163,68756,1062092
Brazil,BRA,2006,97980,767052,19498,57728,66865,69286,1078409
Brazil,BRA,2007,98903,783921,18719,56315,67860,69436,1095154
Brazil,BRA,2008,100518,802971,17992,54713,69192,70743,1116129
Brazil,BRA,2009,103195,823862,17514,53056,69872,72340,1139839
Brazil,BRA,2010,104887,844578,17139,51011,71309,72966,1161890
Brazil,BRA,2011,106577,865193,16744,48806,73944,73173,1184437
Brazil,BRA,2012,107811,875197,16217,46382,71386,75842,1192835
Brazil,BRA,2013,110557,892553,15896,43936,71288,76845,1211075
Brazil,BRA,2014,112318,907712,15445,41275,69999,78414,1225163
Brazil,BRA,2015,115304,931190,15274,38932,68452,78378,1247530
Brazil,BRA,2016,118912,965426,15285,36930,68290,80028,1284871
Brazil,BRA,2017,118496,973604,15036,35230,66440,79746,1288552
Brazil,BRA,2018,118445,998714,15475,33163,66114,77818,1309729
Brazil,BRA,2019,119564,1028931,15869,31596,65825,77005,1338790
Brunei,BRN,1990,68,790,2,29,113,13,1015
Brunei,BRN,1991,66,790,2,30,113,13,1014
Brunei,BRN,1992,65,793,2,29,114,14,1017
Brunei,BRN,1993,64,795,2,29,115,14,1019
Brunei,BRN,1994,61,779,2,28,114,14,998
Brunei,BRN,1995,61,776,2,27,113,14,993
Brunei,BRN,1996,59,771,2,26,115,15,988
Brunei,BRN,1997,59,798,2,25,110,15,1009
Brunei,BRN,1998,61,819,2,25,103,12,1022
Brunei,BRN,1999,62,836,2,25,97,12,1034
Brunei,BRN,2000,61,849,2,26,92,10,1040
Brunei,BRN,2001,61,856,2,26,90,9,1044
Brunei,BRN,2002,63,885,1,27,89,10,1075
Brunei,BRN,2003,66,928,1,28,90,10,1123
Brunei,BRN,2004,69,955,1,27,91,10,1153
Brunei,BRN,2005,68,982,1,26,90,10,1177
Brunei,BRN,2006,71,1000,1,25,89,10,1196
Brunei,BRN,2007,72,1010,1,25,90,10,1208
Brunei,BRN,2008,75,1017,1,24,87,11,1215
Brunei,BRN,2009,78,1053,1,24,85,11,1252
Brunei,BRN,2010,82,1094,1,25,88,11,1301
Brunei,BRN,2011,86,1119,1,26,90,11,1333
Brunei,BRN,2012,89,1154,1,27,94,11,1376
Brunei,BRN,2013,96,1210,1,29,96,11,1443
Brunei,BRN,2014,100,1254,1,29,97,11,1492
Brunei,BRN,2015,105,1300,1,29,101,11,1547
Brunei,BRN,2016,106,1348,1,27,99,11,1592
Brunei,BRN,2017,109,1401,1,26,103,11,1651
Brunei,BRN,2018,112,1455,1,26,105,11,1710
Brunei,BRN,2019,114,1507,1,26,107,12,1767
Bulgaria,BGR,1990,4590,101485,7,548,3823,955,111408
Bulgaria,BGR,1991,4373,101876,5,566,3756,1002,111578
Bulgaria,BGR,1992,4310,105238,7,534,3912,1089,115090
Bulgaria,BGR,1993,4294,109649,7,479,4010,1149,119588
Bulgaria,BGR,1994,4383,114280,7,472,4144,1234,124520
Bulgaria,BGR,1995,4258,117002,8,414,4088,1199,126969
Bulgaria,BGR,1996,4269,119716,13,412,4023,1205,129638
Bulgaria,BGR,1997,4261,123910,16,422,4071,1159,133839
Bulgaria,BGR,1998,3932,121069,15,394,3949,1113,130472
Bulgaria,BGR,1999,3589,117698,18,426,3754,957,126442
Bulgaria,BGR,2000,3385,118632,16,389,3681,978,127081
Bulgaria,BGR,2001,3113,117920,15,369,3552,881,125850
Bulgaria,BGR,2002,2919,117601,16,343,3402,828,125109
Bulgaria,BGR,2003,2809,117139,15,329,3261,794,124347
Bulgaria,BGR,2004,2713,117466,15,329,3142,791,124456
Bulgaria,BGR,2005,2746,119647,19,305,3064,730,126511
Bulgaria,BGR,2006,2716,121235,20,298,3019,706,127994
Bulgaria,BGR,2007,2653,120187,21,297,2888,644,126690
Bulgaria,BGR,2008,2577,118620,20,299,2778,621,124915
Bulgaria,BGR,2009,2485,117642,20,318,2637,597,123699
Bulgaria,BGR,2010,2386,117964,19,308,2506,563,123746
Bulgaria,BGR,2011,2303,117680,17,269,2378,510,123157
Bulgaria,BGR,2012,2237,116099,17,244,2278,603,121478
Bulgaria,BGR,2013,2166,114464,16,230,2207,485,119568
Bulgaria,BGR,2014,2227,117870,17,225,2132,510,122981
Bulgaria,BGR,2015,2181,117755,15,197,2099,502,122749
Bulgaria,BGR,2016,2196,117613,16,188,2082,510,122605
Bulgaria,BGR,2017,2202,117635,16,185,2067,510,122615
Bulgaria,BGR,2018,2230,119613,16,174,2063,513,124609
Bulgaria,BGR,2019,2230,119851,15,164,2042,513,124815
Burkina Faso,BFA,1990,84410,24731,6757,13784,4203,1361,135246
Burkina Faso,BFA,1991,87111,24876,6920,13808,4162,1363,138240
Burkina Faso,BFA,1992,89738,25298,7122,13881,4178,1379,141596
Burkina Faso,BFA,1993,91407,25813,7375,14044,4221,1407,144267
Burkina Faso,BFA,1994,93051,26345,7649,14255,4290,1430,147020
Burkina Faso,BFA,1995,94680,26936,7974,14426,4315,1462,149793
Burkina Faso,BFA,1996,99109,27312,8344,14597,4328,1482,155172
Burkina Faso,BFA,1997,97296,27925,8851,14789,4391,1510,154762
Burkina Faso,BFA,1998,95707,28457,9416,14941,4471,1545,154537
Burkina Faso,BFA,1999,96195,29576,9894,14810,4520,1567,156562
Burkina Faso,BFA,2000,99213,31147,10547,14870,4684,1627,162088
Burkina Faso,BFA,2001,101641,31307,10807,14646,4647,1617,164665
Burkina Faso,BFA,2002,103333,32252,11438,14515,4709,1623,167870
Burkina Faso,BFA,2003,102688,32725,11836,15110,4856,1722,168937
Burkina Faso,BFA,2004,100263,33636,12277,15612,5012,1774,168574
Burkina Faso,BFA,2005,98566,34567,12625,16044,5183,1753,168738
Burkina Faso,BFA,2006,96209,35068,12358,16445,5316,1799,167195
Burkina Faso,BFA,2007,95156,35421,11114,16865,5407,1809,165772
Burkina Faso,BFA,2008,95491,36144,10305,16929,5467,1859,166195
Burkina Faso,BFA,2009,95694,36984,9553,17091,5601,1899,166822
Burkina Faso,BFA,2010,96157,38209,8886,17522,5902,2005,168681
Burkina Faso,BFA,2011,95385,39000,8504,17946,6047,2062,168944
Burkina Faso,BFA,2012,96577,40516,8306,18460,6508,2223,172590
Burkina Faso,BFA,2013,93955,42216,8356,19199,6899,2346,172971
Burkina Faso,BFA,2014,91193,43603,8155,19590,7251,2489,172281
Burkina Faso,BFA,2015,90026,45607,8273,19983,7631,2640,174160
Burkina Faso,BFA,2016,86952,47248,8299,20411,8062,2867,173839
Burkina Faso,BFA,2017,83628,49224,8233,20771,8365,3001,173222
Burkina Faso,BFA,2018,81814,50838,8122,21149,8376,3265,173564
Burkina Faso,BFA,2019,81721,51738,7878,21357,8446,3825,174965
Burundi,BDI,1990,49425,20409,7995,9016,2577,405,89827
Burundi,BDI,1991,51378,20536,7792,8787,2563,790,91846
Burundi,BDI,1992,53684,20628,7435,8561,2532,511,93351
Burundi,BDI,1993,54710,20952,7255,8886,2596,405,94804
Burundi,BDI,1994,57272,21008,7020,8992,2628,13165,110085
Burundi,BDI,1995,58889,21115,6920,8774,2613,13481,111792
Burundi,BDI,1996,59367,21030,6721,8646,2586,14265,112615
Burundi,BDI,1997,59207,20780,6619,8739,2586,14427,112358
Burundi,BDI,1998,59115,20547,6636,8827,2576,13494,111195
Burundi,BDI,1999,58529,20118,6632,8816,2537,13700,110332
Burundi,BDI,2000,57673,19860,6482,8819,2500,14629,109963
Burundi,BDI,2001,56057,19317,6225,8802,2471,14052,106924
Burundi,BDI,2002,55525,19297,6490,8929,2548,13640,106429
Burundi,BDI,2003,53965,19415,6595,9097,2626,13864,105562
Burundi,BDI,2004,51387,19702,6661,9325,2684,13238,102997
Burundi,BDI,2005,48792,20014,6943,9513,2775,13354,101391
Burundi,BDI,2006,46573,20057,6524,9644,2821,679,86298
Burundi,BDI,2007,44762,20135,6182,9810,2829,536,84254
Burundi,BDI,2008,43230,20308,5688,10043,2827,746,82842
Burundi,BDI,2009,42389,20564,5423,10181,2846,944,82347
Burundi,BDI,2010,41480,21222,5515,10225,2953,752,82147
Burundi,BDI,2011,40213,21778,5432,10299,3018,695,81435
Burundi,BDI,2012,38473,22417,5351,10373,3041,535,80190
Burundi,BDI,2013,37744,22936,5325,10369,3130,543,80047
Burundi,BDI,2014,36880,23379,5100,10188,3221,578,79346
Burundi,BDI,2015,36338,23878,4676,9982,3135,1179,79188
Burundi,BDI,2016,36275,24307,4168,9891,3096,876,78613
Burundi,BDI,2017,35854,25035,3922,9946,3114,795,78666
Burundi,BDI,2018,35362,26189,4100,10116,3239,852,79858
Burundi,BDI,2019,35298,27025,4030,10095,3314,649,80411
Cambodia,KHM,1990,43576,38714,8706,11184,5272,1055,108507
Cambodia,KHM,1991,43281,39292,8087,11039,5362,1022,108083
Cambodia,KHM,1992,42963,40015,7510,10893,5254,948,107583
Cambodia,KHM,1993,42964,40960,6979,10677,5254,1181,108015
Cambodia,KHM,1994,43100,41988,6496,10472,5786,1504,109346
Cambodia,KHM,1995,43103,42978,6031,10246,5299,1465,109122
Cambodia,KHM,1996,42942,43746,5532,9912,5322,1626,109080
Cambodia,KHM,1997,42926,44532,5050,9563,5257,1305,108633
Cambodia,KHM,1998,42713,45537,4590,9220,5251,1084,108395
Cambodia,KHM,1999,42495,46483,4141,8976,5228,753,108076
Cambodia,KHM,2000,42368,47267,3701,8687,5481,736,108240
Cambodia,KHM,2001,41217,48288,3316,8410,5224,705,107160
Cambodia,KHM,2002,40433,49369,2998,8231,5257,694,106982
Cambodia,KHM,2003,39315,50424,2653,8014,5193,685,106284
Cambodia,KHM,2004,37529,51634,2347,7826,5184,683,105203
Cambodia,KHM,2005,35435,52744,2084,7626,5164,683,103736
Cambodia,KHM,2006,33677,53719,1840,7413,5020,677,102346
Cambodia,KHM,2007,31360,55088,1649,7246,5003,689,101035
Cambodia,KHM,2008,29694,56445,1488,7069,4938,691,100325
Cambodia,KHM,2009,28446,57939,1361,6864,4901,695,100206
Cambodia,KHM,2010,27147,59848,1280,6659,4912,738,100584
Cambodia,KHM,2011,26062,61664,1207,6374,5093,740,101140
Cambodia,KHM,2012,25169,63405,1160,6170,4880,739,101523
Cambodia,KHM,2013,24392,65182,1113,5982,5046,743,102458
Cambodia,KHM,2014,24016,67069,1087,5819,4931,746,103668
Cambodia,KHM,2015,23419,69132,1064,5681,4917,748,104961
Cambodia,KHM,2016,22918,71298,1040,5505,4945,754,106460
Cambodia,KHM,2017,22536,73684,1022,5306,4938,748,108234
Cambodia,KHM,2018,22071,76111,1004,5108,4957,752,110003
Cambodia,KHM,2019,21742,78461,989,4917,4957,744,111810
Cameroon,CMR,1990,49889,27796,3067,13482,3744,650,98628
Cameroon,CMR,1991,52806,28658,3111,13741,3947,763,103026
Cameroon,CMR,1992,55794,29658,3189,14019,4171,746,107577
Cameroon,CMR,1993,59773,30807,3261,14318,4392,801,113352
Cameroon,CMR,1994,63430,31826,3272,14557,4597,924,118606
Cameroon,CMR,1995,67906,32945,3272,14784,4806,837,124550
Cameroon,CMR,1996,73065,34180,3283,15076,5048,879,131531
Cameroon,CMR,1997,78418,35664,3295,15422,5335,923,139057
Cameroon,CMR,1998,84341,37280,3303,15685,5624,1026,147259
Cameroon,CMR,1999,90097,38727,3288,16000,5900,1019,155031
Cameroon,CMR,2000,96261,40499,3154,16356,6141,1082,163493
Cameroon,CMR,2001,102432,41654,2902,16696,6364,1089,171137
Cameroon,CMR,2002,113308,43364,3044,17281,6811,1158,184966
Cameroon,CMR,2003,118935,44701,2947,17962,7094,1187,192826
Cameroon,CMR,2004,121615,45983,2832,18636,7262,1212,197540
Cameroon,CMR,2005,122296,47526,2750,19232,7493,1295,200592
Cameroon,CMR,2006,122359,49099,2684,19674,7698,1326,202840
Cameroon,CMR,2007,120362,49894,2546,20019,7849,1319,201989
Cameroon,CMR,2008,117425,51345,2478,20160,7990,1340,200738
Cameroon,CMR,2009,115386,52980,2479,20304,8252,1370,200771
Cameroon,CMR,2010,115642,54803,2521,20218,8603,1442,203229
Cameroon,CMR,2011,113533,56625,2522,20263,8865,1511,203319
Cameroon,CMR,2012,109323,58184,2444,20168,9055,1537,200711
Cameroon,CMR,2013,109415,59864,2413,20145,9288,1597,202722
Cameroon,CMR,2014,108680,61222,2331,19996,9457,2733,204419
Cameroon,CMR,2015,104982,62575,2153,19644,9360,3318,202032
Cameroon,CMR,2016,104427,63685,2158,19319,9631,2630,201850
Cameroon,CMR,2017,99219,64955,2050,18931,9698,2459,197312
Cameroon,CMR,2018,93171,66694,1943,18734,9791,3267,193600
Cameroon,CMR,2019,90415,68160,1864,18605,9885,2342,191271
Canada,CAN,1990,7796,163128,376,1273,9244,2074,183891
Canada,CAN,1991,8115,165390,395,1204,9101,2170,186375
Canada,CAN,1992,8456,167906,410,1160,9041,2219,189192
Canada,CAN,1993,8878,172256,427,1172,9071,2255,194059
Canada,CAN,1994,9165,174861,449,1180,8946,2310,196911
Canada,CAN,1995,9696,177940,467,1141,8894,2258,200396
Canada,CAN,1996,9454,180035,487,1065,8791,2304,202136
Canada,CAN,1997,9026,182126,509,1016,8705,2272,203654
Canada,CAN,1998,8915,184477,530,968,8626,2379,205895
Canada,CAN,1999,8558,185493,549,947,8566,2428,206541
Canada,CAN,2000,7957,186233,571,944,8313,2481,206499
Canada,CAN,2001,7628,187459,592,984,8230,2564,207457
Canada,CAN,2002,7586,189784,612,997,8168,2642,209789
Canada,CAN,2003,7702,191654,618,1024,8121,2671,211790
Canada,CAN,2004,7881,192139,619,1036,7961,2772,212408
Canada,CAN,2005,8108,193665,618,1081,7969,2921,214362
Canada,CAN,2006,8160,194037,605,1087,7839,3016,214744
Canada,CAN,2007,8378,197080,600,1126,7825,3102,218111
Canada,CAN,2008,8523,199083,593,1139,7748,3257,220343
Canada,CAN,2009,8649,199674,577,1119,7670,3295,220984
Canada,CAN,2010,8813,200853,569,1124,7581,3429,222369
Canada,CAN,2011,9005,202407,551,1095,7446,3513,224017
Canada,CAN,2012,9223,206147,532,1098,7524,3655,228179
Canada,CAN,2013,9460,209726,523,1124,7569,3797,232199
Canada,CAN,2014,9824,215067,524,1077,7699,3969,238160
Canada,CAN,2015,10173,218660,542,1050,7785,4175,242385
Canada,CAN,2016,10339,223859,568,1030,7900,4348,248044
Canada,CAN,2017,10564,229376,590,983,7875,4476,253864
Canada,CAN,2018,11076,241104,628,956,7822,4651,266237
Canada,CAN,2019,11371,248511,656,940,7769,4700,273947
Cape Verde,CPV,1990,662,1222,97,189,81,45,2296
Cape Verde,CPV,1991,694,1251,101,184,82,47,2359
Cape Verde,CPV,1992,703,1273,97,183,86,49,2391
Cape Verde,CPV,1993,711,1317,92,186,93,52,2451
Cape Verde,CPV,1994,730,1345,94,192,98,56,2515
Cape Verde,CPV,1995,902,1370,86,199,106,58,2721
Cape Verde,CPV,1996,706,1426,85,212,115,61,2605
Cape Verde,CPV,1997,707,1498,74,222,126,66,2693
Cape Verde,CPV,1998,696,1511,71,224,135,67,2704
Cape Verde,CPV,1999,695,1533,61,233,144,68,2734
Cape Verde,CPV,2000,676,1545,55,230,148,69,2723
Cape Verde,CPV,2001,660,1566,51,229,150,73,2729
Cape Verde,CPV,2002,645,1588,47,228,153,75,2736
Cape Verde,CPV,2003,632,1608,43,225,154,78,2740
Cape Verde,CPV,2004,612,1631,39,221,155,81,2739
Cape Verde,CPV,2005,584,1655,35,216,157,83,2730
Cape Verde,CPV,2006,540,1586,33,212,155,83,2609
Cape Verde,CPV,2007,508,1583,29,205,155,83,2563
Cape Verde,CPV,2008,486,1612,27,196,154,88,2563
Cape Verde,CPV,2009,475,1646,25,187,159,92,2584
Cape Verde,CPV,2010,465,1680,23,177,162,98,2605
Cape Verde,CPV,2011,458,1749,22,164,162,101,2656
Cape Verde,CPV,2012,452,1802,23,160,165,102,2704
Cape Verde,CPV,2013,442,1838,23,151,167,102,2723
Cape Verde,CPV,2014,440,1902,23,142,171,103,2781
Cape Verde,CPV,2015,439,1983,23,133,182,102,2862
Cape Verde,CPV,2016,450,2109,23,123,176,101,2982
Cape Verde,CPV,2017,449,2174,23,114,179,99,3038
Cape Verde,CPV,2018,493,2558,25,106,180,93,3455
Cape Verde,CPV,2019,487,2549,23,98,179,92,3428
Central African Republic,CAF,1990,23003,10348,1795,4649,2193,377,42365
Central African Republic,CAF,1991,24796,10565,1807,4739,2275,395,44577
Central African Republic,CAF,1992,26821,10570,1819,4806,2296,398,46710
Central African Republic,CAF,1993,29240,10810,1859,4943,2390,414,49656
Central African Republic,CAF,1994,31288,11005,1896,5038,2458,418,52103
Central African Republic,CAF,1995,33084,11158,1942,5134,2506,421,54245
Central African Republic,CAF,1996,34987,11504,2027,5303,2667,492,56980
Central African Republic,CAF,1997,36362,11625,2103,5419,2739,580,58828
Central African Republic,CAF,1998,37621,11855,2210,5572,2897,461,60616
Central African Republic,CAF,1999,38920,12082,2351,5721,3078,474,62626
Central African Republic,CAF,2000,39274,12133,2452,5822,3143,474,63298
Central African Republic,CAF,2001,40036,12267,2546,5945,3232,738,64764
Central African Republic,CAF,2002,40308,12476,2654,6093,3345,782,65658
Central African Republic,CAF,2003,40631,12638,2756,6240,3421,528,66214
Central African Republic,CAF,2004,40842,12806,2841,6378,3487,578,66932
Central African Republic,CAF,2005,40848,12968,2902,6493,3553,519,67283
Central African Republic,CAF,2006,41468,13194,3060,6581,3711,750,68764
Central African Republic,CAF,2007,41201,13349,3115,6657,3778,810,68910
Central African Republic,CAF,2008,39965,13467,3130,6730,3789,660,67741
Central African Republic,CAF,2009,39372,13762,3164,6832,3893,875,67898
Central African Republic,CAF,2010,39481,14248,3186,6963,4063,890,68831
Central African Republic,CAF,2011,39086,14612,3129,6986,4129,828,68770
Central African Republic,CAF,2012,38451,14787,3058,6794,4074,772,67936
Central African Republic,CAF,2013,38354,15080,3016,6626,4096,5137,72309
Central African Republic,CAF,2014,37581,15246,2914,6492,4039,6199,72471
Central African Republic,CAF,2015,36499,15495,2795,6440,4025,1572,66826
Central African Republic,CAF,2016,35572,15756,2685,6370,4041,1582,66006
Central African Republic,CAF,2017,35035,16037,2632,6285,4090,2931,67010
Central African Republic,CAF,2018,34213,16336,2543,6258,4112,1513,64975
Central African Republic,CAF,2019,33565,16639,2458,6194,4129,992,63977
Chad,TCD,2007,73427,26431,7345,15407,3734,1733,128077
Chad,TCD,2008,73334,27147,7056,15848,3775,2316,129476
Chad,TCD,2009,73189,27872,6806,16318,3858,1433,129476
Chad,TCD,2015,72744,32057,5510,18816,4283,2093,135503
Chad,TCD,1990,43410,18008,11348,10913,2107,1288,87074
Chad,TCD,1991,45339,18115,10980,10988,2153,740,88315
Chad,TCD,1992,45621,18584,10879,11145,2197,1998,90424
Chad,TCD,1993,47474,19129,10872,11397,2299,998,92169
Chad,TCD,1994,48883,19486,10748,11563,2363,1229,94272
Chad,TCD,1995,50601,19877,10835,11896,2437,791,96437
Chad,TCD,1996,53178,20687,10965,12306,2601,804,100541
Chad,TCD,1997,55999,21273,10921,12622,2745,1096,104656
Chad,TCD,1998,58925,21750,10894,12884,2875,1134,108462
Chad,TCD,1999,60748,22260,10815,13106,3010,1388,111327
Chad,TCD,2000,63406,22658,10347,13265,3108,2073,114857
Chad,TCD,2001,66196,23173,9503,13400,3294,1289,116855
Chad,TCD,2002,67416,23779,9026,13699,3270,1425,118615
Chad,TCD,2003,69279,24454,8559,14138,3380,1141,120951
Chad,TCD,2004,69761,24888,8056,14391,3403,1295,121794
Chad,TCD,2005,69804,25163,7591,14651,3435,1559,122203
Chad,TCD,2006,71692,25698,7473,14942,3585,3757,127147
Chad,TCD,2010,73319,28619,6564,16785,3990,1380,130657
Chad,TCD,2011,72930,29339,6290,17225,4007,1385,131176
Chad,TCD,2012,71913,30063,6028,17659,4077,1421,131161
Chad,TCD,2013,72677,30664,5921,18071,4189,1499,133021
Chad,TCD,2014,72100,31316,5648,18484,4232,1558,133338
Chad,TCD,2016,73071,32799,5315,19238,4358,1643,136424
Chad,TCD,2017,74155,33650,5125,19713,4455,1766,138864
Chad,TCD,2018,73568,34549,4941,20217,4560,2064,139899
Chad,TCD,2019,73730,35342,4830,20586,4661,2103,141252
Chile,CHL,1990,8177,56189,365,1940,5752,1578,74001
Chile,CHL,1991,7787,55012,362,1738,5781,1521,72201
Chile,CHL,1992,7722,54581,364,1652,5502,1412,71233
Chile,CHL,1993,7896,55659,397,1512,5757,1335,72556
Chile,CHL,1994,8025,56661,433,1363,5689,1313,73484
Chile,CHL,1995,8334,58540,489,1285,5809,1377,75834
Chile,CHL,1996,8457,59922,568,1215,5786,1343,77291
Chile,CHL,1997,8147,59928,629,1131,5690,1347,76872
Chile,CHL,1998,7784,61197,788,1168,5467,1378,77782
Chile,CHL,1999,7499,62613,893,1126,5317,1383,78831
Chile,CHL,2000,6603,62922,932,1025,5258,1398,78138
Chile,CHL,2001,6236,65203,970,955,5279,1459,80102
Chile,CHL,2002,5676,66205,1002,857,5157,1488,80385
Chile,CHL,2003,5450,68536,1066,850,5165,1492,82559
Chile,CHL,2004,5357,70104,1095,916,5184,1508,84164
Chile,CHL,2005,5144,70442,1116,899,5168,1587,84356
Chile,CHL,2006,5055,70978,1113,898,5119,1562,84725
Chile,CHL,2007,5092,72381,1134,931,5261,1380,86179
Chile,CHL,2008,5007,72578,1102,920,5265,1460,86332
Chile,CHL,2009,5245,75825,1130,962,5415,1435,90012
Chile,CHL,2010,5401,78687,1153,911,5892,1470,93514
Chile,CHL,2011,5381,79643,1122,924,5141,1456,93667
Chile,CHL,2012,5476,81266,1085,892,5028,1410,95157
Chile,CHL,2013,5654,83229,1053,857,5029,1389,97211
Chile,CHL,2014,5657,84567,1004,896,5015,1460,98599
Chile,CHL,2015,5621,86707,999,813,5199,1445,100784
Chile,CHL,2016,5566,87579,989,759,4968,1397,101258
Chile,CHL,2017,5829,91136,1045,698,5030,1437,105175
Chile,CHL,2018,6026,93995,1085,667,5005,1457,108235
Chile,CHL,2019,6218,96733,1126,643,5008,1471,111199
China,CHN,2007,296852,7674944,18489,104554,572533,87829,8755201
China,CHN,2008,288369,7825082,18529,98073,655417,87200,8972670
China,CHN,2009,282126,8030645,18972,91660,564654,86776,9074833
China,CHN,2010,277111,8256107,19718,83495,563081,85152,9284664
China,CHN,2011,271519,8378947,20548,79251,533577,83132,9366974
China,CHN,2012,264757,8410724,21265,77520,509526,80795,9364587
China,CHN,2013,260483,8487354,22438,71719,490538,79396,9411928
China,CHN,2014,259021,8599064,23893,65581,478138,78207,9503904
China,CHN,2015,261372,8697084,25663,68354,462218,76531,9591222
China,CHN,2016,268979,8914571,28089,69414,457174,75986,9814213
China,CHN,1990,882530,5968467,82191,303288,617628,110028,7964132
China,CHN,1991,858330,6068605,82826,298768,613093,111865,8033487
China,CHN,1992,821898,6156437,73993,289116,605087,112537,8059068
China,CHN,1993,775446,6241143,68712,278907,600803,112781,8077792
China,CHN,1994,732560,6278436,63903,269234,610848,115477,8070458
China,CHN,1995,687341,6333766,57441,257092,615101,116431,8067172
China,CHN,1996,640595,6417243,52422,244461,609807,115082,8079610
China,CHN,1997,594213,6469265,47629,230331,597278,112315,8051031
China,CHN,1998,553472,6556491,42508,217223,600698,111951,8082343
China,CHN,1999,519524,6739353,38245,203209,593420,109723,8203474
China,CHN,2000,487638,6990213,34306,189701,593903,108398,8404159
China,CHN,2001,450803,7147923,30593,174901,582486,104222,8490928
China,CHN,2002,417476,7328846,26541,159434,579396,99263,8610956
China,CHN,2003,386194,7508936,23370,144411,591526,95924,8750361
China,CHN,2004,365544,7736888,21262,133313,608332,95345,8960684
China,CHN,2005,343959,7799993,20067,122857,602443,93383,8982702
China,CHN,2006,316341,7672051,19366,113338,583211,90089,8794396
China,CHN,2017,267537,9097724,29422,59567,449283,75120,9978653
China,CHN,2018,266506,9296773,29537,51664,444575,74888,10163943
China,CHN,2019,269207,9582824,29962,46487,439157,74924,10442561
Colombia,COL,1990,16860,89606,3881,14304,10433,25927,161011
Colombia,COL,1991,17741,94985,3774,14425,11187,29914,172026
Colombia,COL,1992,17862,97694,3644,14466,11256,31545,176467
Colombia,COL,1993,16758,99501,3437,14317,11781,30213,176007
Colombia,COL,1994,16245,101803,3335,13947,12017,30175,177522
Colombia,COL,1995,16601,103323,3274,13497,12180,28797,177672
Colombia,COL,1996,15628,107016,3397,13149,12404,30053,181647
Colombia,COL,1997,15836,105085,3289,12787,11945,30099,179041
Colombia,COL,1998,15220,105899,3418,12391,11696,31430,180054
Colombia,COL,1999,13537,110695,3668,11977,12638,33180,185695
Colombia,COL,2000,13422,113728,3807,11652,11565,35992,190166
Colombia,COL,2001,13920,117355,3892,11225,11140,37295,194827
Colombia,COL,2002,14092,130452,4004,10821,12288,43086,214743
Colombia,COL,2003,13742,127831,3838,10509,11741,28412,196073
Colombia,COL,2004,13490,130118,3685,10224,11765,26542,195824
Colombia,COL,2005,13092,128751,3505,9988,11512,22747,189595
Colombia,COL,2006,13094,133672,3361,9566,11950,21462,193105
Colombia,COL,2007,12900,133927,3137,9131,11755,20096,190946
Colombia,COL,2008,12535,138010,3112,8543,11778,19970,193948
Colombia,COL,2009,12565,144536,3072,8299,12197,20532,201201
Colombia,COL,2010,12504,146805,2966,7617,12293,19723,201908
Colombia,COL,2011,11921,145298,2792,6959,11858,18777,197605
Colombia,COL,2012,11890,148687,2723,6643,11465,18354,199762
Colombia,COL,2013,12007,151730,2637,6452,11367,17555,201748
Colombia,COL,2014,12044,155169,2568,6085,11389,15987,203242
Colombia,COL,2015,12384,162303,2566,5939,11675,15732,210599
Colombia,COL,2016,12366,168412,2548,5378,11379,16829,216912
Colombia,COL,2017,12430,173969,2572,5201,12175,17132,223479
Colombia,COL,2018,12516,181287,2601,4962,11393,17526,230285
Colombia,COL,2019,12605,187517,2619,4730,11300,17391,236162
Comoros,COM,1990,2230,1483,367,761,156,42,5039
Comoros,COM,1991,2230,1513,358,762,162,44,5069
Comoros,COM,1992,2135,1594,356,769,172,49,5075
Comoros,COM,1993,2118,1635,342,772,176,50,5093
Comoros,COM,1994,2063,1703,338,778,184,55,5121
Comoros,COM,1995,2028,1752,328,776,188,58,5130
Comoros,COM,1996,2002,1797,318,775,192,61,5145
Comoros,COM,1997,1997,1823,303,767,191,120,5201
Comoros,COM,1998,2080,1812,285,761,180,102,5220
Comoros,COM,1999,2021,1818,271,756,175,62,5103
Comoros,COM,2000,2022,1872,262,749,177,67,5149
Comoros,COM,2001,1892,1890,248,744,173,68,5015
Comoros,COM,2002,1891,1907,235,728,171,69,5001
Comoros,COM,2003,1825,1900,219,712,166,68,4890
Comoros,COM,2004,1817,1871,214,694,172,65,4833
Comoros,COM,2005,1701,1938,210,683,185,70,4787
Comoros,COM,2006,1850,1909,200,659,167,62,4847
Comoros,COM,2007,1690,2041,208,649,194,75,4857
Comoros,COM,2008,1616,2109,204,633,201,77,4840
Comoros,COM,2009,1707,2079,186,611,185,68,4836
Comoros,COM,2010,1781,2082,167,585,162,60,4837
Comoros,COM,2011,1703,2163,167,567,172,65,4837
Comoros,COM,2012,1665,2225,157,541,176,65,4829
Comoros,COM,2013,1571,2285,148,516,178,69,4767
Comoros,COM,2014,1305,2467,158,504,223,91,4748
Comoros,COM,2015,1281,2522,152,483,224,94,4756
Comoros,COM,2016,1255,2573,145,463,224,95,4755
Comoros,COM,2017,1252,2636,142,442,226,97,4795
Comoros,COM,2018,1307,2651,134,421,225,93,4831
Comoros,COM,2019,1315,2697,128,406,230,92,4868
Congo,COG,1990,13640,9365,810,2233,1448,264,27760
Congo,COG,1991,14429,9416,814,2249,1448,264,28620
Congo,COG,1992,15351,9530,826,2271,1472,269,29719
Congo,COG,1993,16283,9747,843,2301,1505,410,31089
Congo,COG,1994,17483,10258,878,2374,1649,331,32973
Congo,COG,1995,18338,10555,901,2423,1713,309,34239
Congo,COG,1996,19083,10906,927,2494,1802,319,35531
Congo,COG,1997,19887,11155,969,2576,1928,10781,47296
Congo,COG,1998,20033,10975,945,2609,1857,4101,40520
Congo,COG,1999,20391,11081,939,2695,1932,1305,38343
Congo,COG,2000,20419,10969,918,2766,1908,817,37797
Congo,COG,2001,20151,10759,876,2789,1811,307,36693
Congo,COG,2002,19869,10712,853,2846,1782,536,36598
Congo,COG,2003,19856,11058,840,2953,1853,359,36919
Congo,COG,2004,19636,11310,819,3028,1871,327,36991
Congo,COG,2005,19359,11540,821,3110,1924,345,37099
Congo,COG,2006,18772,11811,799,3150,1939,333,36804
Congo,COG,2007,18307,12135,784,3187,1964,343,36720
Congo,COG,2008,17406,12470,772,3218,1986,349,36201
Congo,COG,2009,16508,12717,755,3258,2003,455,35696
Congo,COG,2010,15875,12920,722,3271,1989,357,35134
Congo,COG,2011,15394,13138,695,3233,1950,350,34760
Congo,COG,2012,15186,13576,681,3187,2030,366,35026
Congo,COG,2013,15037,13950,656,3106,2022,410,35181
Congo,COG,2014,14805,14340,637,3016,2036,387,35221
Congo,COG,2015,14185,14648,608,2883,2029,380,34733
Congo,COG,2016,13439,14987,578,2727,2028,447,34206
Congo,COG,2017,13179,15450,556,2584,2049,411,34229
Congo,COG,2018,12858,15978,542,2480,2080,414,34352
Congo,COG,2019,12566,16510,534,2394,2118,411,34533
Cook Islands,COK,1990,13,95,0,4,11,0,123
Cook Islands,COK,1991,13,96,0,3,10,0,122
Cook Islands,COK,1992,12,95,0,3,10,0,120
Cook Islands,COK,1993,11,97,0,3,10,0,121
Cook Islands,COK,1994,11,97,0,3,10,0,121
Cook Islands,COK,1995,11,97,0,2,9,0,119
Cook Islands,COK,1996,11,98,0,2,9,0,120
Cook Islands,COK,1997,10,98,0,2,28,0,138
Cook Islands,COK,1998,10,101,0,2,9,0,122
Cook Islands,COK,1999,10,102,0,2,8,0,122
Cook Islands,COK,2000,10,104,0,2,8,0,124
Cook Islands,COK,2001,10,105,0,2,8,0,125
Cook Islands,COK,2002,10,105,0,2,8,0,125
Cook Islands,COK,2003,10,108,0,1,8,0,127
Cook Islands,COK,2004,9,109,0,1,8,0,127
Cook Islands,COK,2005,9,109,0,1,8,0,127
Cook Islands,COK,2006,10,112,0,1,8,0,131
Cook Islands,COK,2007,10,112,0,1,7,0,130
Cook Islands,COK,2008,10,113,0,1,7,0,131
Cook Islands,COK,2009,10,114,0,1,7,0,132
Cook Islands,COK,2010,10,117,0,1,7,0,135
Cook Islands,COK,2011,10,120,0,0,7,0,137
Cook Islands,COK,2012,10,124,0,0,7,0,141
Cook Islands,COK,2013,11,127,0,0,7,0,145
Cook Islands,COK,2014,11,128,0,0,7,0,146
Cook Islands,COK,2015,11,131,0,0,7,0,149
Cook Islands,COK,2016,11,137,0,0,7,0,155
Cook Islands,COK,2017,11,140,0,0,7,0,158
Cook Islands,COK,2018,13,141,0,0,7,0,161
Cook Islands,COK,2019,13,145,0,0,7,0,165
Costa Rica,CRI,1990,803,8134,72,604,871,213,10697
Costa Rica,CRI,1991,833,8521,68,595,927,214,11158
Costa Rica,CRI,1992,841,8938,62,582,946,241,11610
Costa Rica,CRI,1993,862,9186,53,561,964,248,11874
Costa Rica,CRI,1994,916,9873,48,565,1019,274,12695
Costa Rica,CRI,1995,981,10518,44,552,1088,283,13466
Costa Rica,CRI,1996,956,10434,39,523,1115,284,13351
Costa Rica,CRI,1997,978,10804,41,559,1113,295,13790
Costa Rica,CRI,1998,905,11207,37,515,1149,303,14116
Costa Rica,CRI,1999,877,11753,33,489,1206,323,14681
Costa Rica,CRI,2000,816,11714,32,449,1160,316,14487
Costa Rica,CRI,2001,828,12153,29,459,1147,323,14939
Costa Rica,CRI,2002,769,12045,32,448,1181,326,14801
Costa Rica,CRI,2003,776,12517,33,418,1188,361,15293
Costa Rica,CRI,2004,752,12979,33,397,1217,365,15743
Costa Rica,CRI,2005,711,12473,32,382,1126,381,15105
Costa Rica,CRI,2006,732,13338,34,391,1213,425,16133
Costa Rica,CRI,2007,661,12431,31,392,1124,404,15043
Costa Rica,CRI,2008,673,13100,32,374,1143,468,15790
Costa Rica,CRI,2009,659,13342,32,350,1115,500,15998
Costa Rica,CRI,2010,758,15218,38,377,1264,561,18216
Costa Rica,CRI,2011,755,15023,38,364,1182,546,17908
Costa Rica,CRI,2012,818,15393,38,354,1208,532,18343
Costa Rica,CRI,2013,849,15953,38,334,1201,550,18925
Costa Rica,CRI,2014,909,16430,38,325,1218,588,19508
Costa Rica,CRI,2015,953,17356,40,314,1308,664,20635
Costa Rica,CRI,2016,1023,18546,41,313,1424,704,22051
Costa Rica,CRI,2017,1022,19155,43,289,1443,664,22616
Costa Rica,CRI,2018,1030,19805,43,272,1399,634,23183
Costa Rica,CRI,2019,1036,20336,44,258,1383,643,23700
Cote d'Ivoire,CIV,1990,69340,26077,4003,20125,3681,1495,124721
Cote d'Ivoire,CIV,1991,76191,27268,4107,20621,3853,1560,133600
Cote d'Ivoire,CIV,1992,83964,28647,4193,21305,4032,1642,143783
Cote d'Ivoire,CIV,1993,92780,30306,4272,22245,4292,1758,155653
Cote d'Ivoire,CIV,1994,101862,31955,4324,23333,4544,1879,167897
Cote d'Ivoire,CIV,1995,110638,33639,4318,24430,4781,2055,179861
Cote d'Ivoire,CIV,1996,117451,34948,4217,25299,4978,2078,188971
Cote d'Ivoire,CIV,1997,123759,36020,4084,26071,5066,2161,197161
Cote d'Ivoire,CIV,1998,129109,37282,3936,26874,5229,2246,204676
Cote d'Ivoire,CIV,1999,132965,38488,3735,27480,5377,2350,210395
Cote d'Ivoire,CIV,2000,134516,39893,3416,27829,5483,2497,213634
Cote d'Ivoire,CIV,2001,136196,40788,3046,28224,5571,2433,216258
Cote d'Ivoire,CIV,2002,136668,41739,2783,28602,5626,3685,219103
Cote d'Ivoire,CIV,2003,137356,42550,2577,29104,5722,3612,220921
Cote d'Ivoire,CIV,2004,137153,43417,2444,29465,5787,3145,221411
Cote d'Ivoire,CIV,2005,133911,44031,2326,29774,5799,2792,218633
Cote d'Ivoire,CIV,2006,131704,44836,2324,29877,5913,2587,217241
Cote d'Ivoire,CIV,2007,127162,45108,2237,29984,5924,2553,212968
Cote d'Ivoire,CIV,2008,121450,45674,2170,29787,5924,2559,207564
Cote d'Ivoire,CIV,2009,118070,46675,2128,29760,6032,2598,205263
Cote d'Ivoire,CIV,2010,116234,47785,2070,29649,6094,2764,204596
Cote d'Ivoire,CIV,2011,111435,48752,1971,29654,6104,4576,202492
Cote d'Ivoire,CIV,2012,106661,50056,2000,29301,6300,2839,197157
Cote d'Ivoire,CIV,2013,101585,51865,2035,29126,6536,2965,194112
Cote d'Ivoire,CIV,2014,96002,52922,1999,28943,6711,3061,189638
Cote d'Ivoire,CIV,2015,91808,53982,1971,28489,6693,3077,186020
Cote d'Ivoire,CIV,2016,88278,53739,1792,27553,6539,3075,180976
Cote d'Ivoire,CIV,2017,83860,54405,1660,26683,6448,3029,176085
Cote d'Ivoire,CIV,2018,78163,56087,1567,26086,6522,3076,171501
Cote d'Ivoire,CIV,2019,77070,56690,1463,25300,6404,3047,169974
Croatia,HRV,1990,1348,47126,3,330,2449,574,51830
Croatia,HRV,1991,1360,46102,3,295,2330,4058,54148
Croatia,HRV,1992,1397,45552,3,284,2316,2763,52315
Croatia,HRV,1993,1407,45416,3,269,2247,1322,50664
Croatia,HRV,1994,1401,45173,3,263,2194,760,49794
Croatia,HRV,1995,1397,45883,4,250,2172,1505,51211
Croatia,HRV,1996,1418,46830,4,246,2140,685,51323
Croatia,HRV,1997,1465,47788,5,246,2112,566,52182
Croatia,HRV,1998,1445,47459,5,210,2028,551,51698
Croatia,HRV,1999,1440,47114,5,194,1965,529,51247
Croatia,HRV,2000,1366,46029,5,178,1896,505,49979
Croatia,HRV,2001,1338,45591,4,168,1850,480,49431
Croatia,HRV,2002,1380,46160,4,155,1816,454,49969
Croatia,HRV,2003,1410,47029,5,141,1801,487,50873
Croatia,HRV,2004,1372,45686,4,137,1691,489,49379
Croatia,HRV,2005,1337,46725,4,130,1700,502,50398
Croatia,HRV,2006,1195,46270,4,121,1626,498,49714
Croatia,HRV,2007,1071,47469,4,126,1650,511,50831
Croatia,HRV,2008,941,48337,5,119,1631,523,51556
Croatia,HRV,2009,795,47217,4,124,1512,494,50146
Croatia,HRV,2010,692,47490,4,108,1436,484,50214
Croatia,HRV,2011,631,47224,4,100,1393,468,49820
Croatia,HRV,2012,600,47320,4,89,1368,476,49857
Croatia,HRV,2013,567,46318,4,92,1279,438,48698
Croatia,HRV,2014,580,47089,4,85,1263,425,49446
Croatia,HRV,2015,631,49173,4,83,1284,426,51601
Croatia,HRV,2016,621,46951,4,79,1197,418,49270
Croatia,HRV,2017,644,47670,4,74,1190,417,49999
Croatia,HRV,2018,664,48050,4,69,1187,420,50394
Croatia,HRV,2019,688,48723,4,64,1181,424,51084
Cuba,CUB,1990,4469,55336,119,935,5425,1123,67407
Cuba,CUB,1991,4561,56238,128,854,5460,1147,68388
Cuba,CUB,1992,4840,58581,138,756,5510,1078,70903
Cuba,CUB,1993,5234,60541,148,683,5602,1145,73353
Cuba,CUB,1994,5450,61158,156,715,5577,1202,74258
Cuba,CUB,1995,5505,61331,159,694,5406,1126,74221
Cuba,CUB,1996,5642,61455,158,576,5108,1052,73991
Cuba,CUB,1997,5765,60953,152,550,4927,1062,73409
Cuba,CUB,1998,5906,61639,144,551,4792,1132,74164
Cuba,CUB,1999,6134,62361,135,520,4587,1024,74761
Cuba,CUB,2000,6209,62097,122,507,4239,1000,74174
Cuba,CUB,2001,6495,63380,111,476,3986,1004,75452
Cuba,CUB,2002,6130,61446,100,473,3617,1034,72800
Cuba,CUB,2003,6311,63855,102,448,3482,1011,75209
Cuba,CUB,2004,6486,65879,104,410,3387,1014,77280
Cuba,CUB,2005,6532,68124,104,395,3380,1027,79562
Cuba,CUB,2006,6018,66095,96,344,3136,955,76644
Cuba,CUB,2007,5917,67492,96,332,3081,977,77895
Cuba,CUB,2008,5984,69814,101,348,3076,1023,80346
Cuba,CUB,2009,5985,71548,104,356,3091,1085,82169
Cuba,CUB,2010,6096,73536,106,345,3121,1070,84274
Cuba,CUB,2011,5976,71193,105,357,2961,1091,81683
Cuba,CUB,2012,6299,74171,108,334,3093,1201,85206
Cuba,CUB,2013,6606,76311,109,327,3044,1273,87670
Cuba,CUB,2014,6975,78933,112,317,3062,1265,90664
Cuba,CUB,2015,7491,82656,116,324,3173,1332,95092
Cuba,CUB,2016,7550,83927,118,297,3170,1317,96379
Cuba,CUB,2017,7890,88096,121,276,3261,1304,100948
Cuba,CUB,2018,8020,89878,121,248,3240,1288,102795
Cuba,CUB,2019,7867,88694,118,233,3168,1273,101353
Cyprus,CYP,1990,167,4897,7,109,253,41,5474
Cyprus,CYP,1991,177,5149,7,105,259,41,5738
Cyprus,CYP,1992,185,5374,7,97,265,42,5970
Cyprus,CYP,1993,187,5470,7,89,273,42,6068
Cyprus,CYP,1994,185,5451,7,81,280,45,6049
Cyprus,CYP,1995,183,5484,7,73,288,43,6078
Cyprus,CYP,1996,181,5483,7,67,290,46,6074
Cyprus,CYP,1997,183,5533,7,61,298,45,6127
Cyprus,CYP,1998,187,5662,7,54,303,98,6311
Cyprus,CYP,1999,189,5733,7,48,300,45,6322
Cyprus,CYP,2000,183,5659,7,43,296,50,6238
Cyprus,CYP,2001,178,5602,7,39,292,46,6164
Cyprus,CYP,2002,178,5641,7,36,288,46,6196
Cyprus,CYP,2003,176,5671,7,34,279,45,6212
Cyprus,CYP,2004,177,5796,8,32,281,44,6338
Cyprus,CYP,2005,181,5993,9,32,278,47,6540
Cyprus,CYP,2006,185,6205,9,30,274,47,6750
Cyprus,CYP,2007,184,6333,11,28,272,52,6880
Cyprus,CYP,2008,180,6327,11,28,262,48,6856
Cyprus,CYP,2009,179,6349,11,28,249,49,6865
Cyprus,CYP,2010,179,6396,11,27,233,48,6894
Cyprus,CYP,2011,176,6396,11,26,221,47,6877
Cyprus,CYP,2012,173,6441,11,26,215,47,6913
Cyprus,CYP,2013,172,6554,11,24,217,47,7025
Cyprus,CYP,2014,176,6751,13,25,221,48,7234
Cyprus,CYP,2015,182,6940,13,26,222,50,7433
Cyprus,CYP,2016,185,7002,13,27,224,51,7502
Cyprus,CYP,2017,185,7105,13,26,228,52,7609
Cyprus,CYP,2018,194,7375,13,26,231,53,7892
Cyprus,CYP,2019,205,7691,13,25,236,53,8223
Czechia,CZE,1990,2666,115747,24,718,4322,893,124370
Czechia,CZE,1991,2604,111159,22,690,4251,864,119590
Czechia,CZE,1992,2592,108456,22,622,4300,857,116849
Czechia,CZE,1993,2543,104971,19,540,4150,831,113054
Czechia,CZE,1994,2649,104125,18,457,4131,834,112214
Czechia,CZE,1995,2795,105207,18,382,4071,778,113251
Czechia,CZE,1996,2759,101399,15,317,3880,755,109125
Czechia,CZE,1997,2753,101752,15,296,3923,768,109507
Czechia,CZE,1998,2630,98613,14,257,3723,747,105984
Czechia,CZE,1999,2682,98253,14,229,3707,753,105638
Czechia,CZE,2000,2748,98938,16,216,3724,794,106436
Czechia,CZE,2001,2775,98472,17,206,3709,819,105998
Czechia,CZE,2002,2773,98382,18,214,3606,826,105819
Czechia,CZE,2003,2913,100975,20,208,3616,870,108602
Czechia,CZE,2004,2876,98019,24,207,3433,886,105445
Czechia,CZE,2005,3007,98173,30,196,3325,892,105623
Czechia,CZE,2006,2994,95565,37,201,3146,919,102862
Czechia,CZE,2007,3017,95356,53,202,3099,905,102632
Czechia,CZE,2008,3078,96152,70,192,3081,900,103473
Czechia,CZE,2009,3143,96234,85,184,3004,903,103553
Czechia,CZE,2010,3179,96881,107,170,2957,933,104227
Czechia,CZE,2011,3204,97878,140,158,2907,895,105182
Czechia,CZE,2012,3263,98344,176,152,2839,923,105697
Czechia,CZE,2013,3327,98770,213,144,2766,890,106110
Czechia,CZE,2014,3380,97659,245,145,2642,883,104954
Czechia,CZE,2015,3585,99667,284,150,2618,894,107198
Czechia,CZE,2016,3704,100132,302,172,2557,888,107755
Czechia,CZE,2017,3828,101320,308,174,2527,895,109052
Czechia,CZE,2018,3826,103774,275,149,2524,898,111446
Czechia,CZE,2019,3794,104124,253,133,2464,893,111661
Democratic Republic of Congo,COD,1990,248525,110092,28112,49099,27362,3186,466376
Democratic Republic of Congo,COD,1991,258091,113969,28592,49717,28142,3156,481667
Democratic Republic of Congo,COD,1992,266770,117020,29171,50052,28570,3244,494827
Democratic Republic of Congo,COD,1993,275702,119179,29945,50486,28730,6474,510516
Democratic Republic of Congo,COD,1994,289940,122182,30811,50849,28975,3539,526296
Democratic Republic of Congo,COD,1995,296431,126239,31587,51493,29715,3872,539337
Democratic Republic of Congo,COD,1996,307349,131666,32608,52258,30479,38055,592415
Democratic Republic of Congo,COD,1997,315186,131836,33696,52360,30226,17879,581183
Democratic Republic of Congo,COD,1998,325466,135225,34748,53147,30754,13731,593071
Democratic Republic of Congo,COD,1999,331987,137965,35839,53997,31321,13868,604977
Democratic Republic of Congo,COD,2000,341617,141113,36929,55230,32304,7313,614506
Democratic Republic of Congo,COD,2001,345098,144012,36913,56692,32800,6432,621947
Democratic Republic of Congo,COD,2002,344726,145629,35952,58513,33257,12986,631063
Democratic Republic of Congo,COD,2003,351251,150350,35052,60736,34190,8574,640153
Democratic Republic of Congo,COD,2004,346638,152132,33387,62461,34102,4854,633574
Democratic Republic of Congo,COD,2005,343797,153741,32329,63506,34615,4545,632533
Democratic Republic of Congo,COD,2006,343545,156954,31631,64488,35257,4531,636406
Democratic Republic of Congo,COD,2007,342096,159814,30646,65321,35574,5136,638587
Democratic Republic of Congo,COD,2008,339290,164242,29581,65977,36073,8030,643193
Democratic Republic of Congo,COD,2009,331072,167723,28692,66287,36468,11101,641343
Democratic Republic of Congo,COD,2010,318998,170731,27318,65990,36734,5904,625675
Democratic Republic of Congo,COD,2011,306476,175384,26084,66060,37284,5127,616415
Democratic Republic of Congo,COD,2012,292083,179654,24874,65422,37838,7141,607012
Democratic Republic of Congo,COD,2013,275480,182942,23369,64377,37915,7885,591968
Democratic Republic of Congo,COD,2014,261429,186469,21410,62626,38444,6377,576755
Democratic Republic of Congo,COD,2015,247030,189064,19171,60503,39415,6483,561666
Democratic Republic of Congo,COD,2016,236130,192676,16699,58490,38883,7626,550504
Democratic Republic of Congo,COD,2017,223186,197672,14588,56473,38977,12334,543230
Democratic Republic of Congo,COD,2018,207602,204617,13613,54948,39204,8296,528280
Democratic Republic of Congo,COD,2019,199366,210325,12384,53095,38891,7002,521063
Denmark,DNK,1990,2116,51497,130,196,2431,616,56986
Denmark,DNK,1991,2162,51443,130,197,2359,640,56931
Denmark,DNK,1992,2256,52198,131,189,2302,656,57732
Denmark,DNK,1993,2325,52936,127,172,2249,671,58480
Denmark,DNK,1994,2514,53478,118,176,2156,688,59130
Denmark,DNK,1995,2585,53606,112,171,2056,693,59223
Denmark,DNK,1996,2449,52636,109,171,1952,715,58032
Denmark,DNK,1997,2182,51637,108,165,1832,744,56668
Denmark,DNK,1998,2015,50432,119,154,1726,788,55234
Denmark,DNK,1999,2005,50754,143,147,1704,856,55609
Denmark,DNK,2000,1949,49814,159,154,1584,906,54566
Denmark,DNK,2001,2088,50392,173,155,1542,944,55294
Denmark,DNK,2002,2290,50433,199,150,1523,995,55590
Denmark,DNK,2003,2412,49540,201,151,1466,1037,54807
Denmark,DNK,2004,2461,48491,201,151,1415,1082,53801
Denmark,DNK,2005,2502,47515,192,150,1347,1145,52851
Denmark,DNK,2006,2598,47451,186,138,1329,1162,52864
Denmark,DNK,2007,2700,47301,176,145,1314,1193,52829
Denmark,DNK,2008,2754,46730,159,144,1272,1213,52272
Denmark,DNK,2009,2846,46655,151,128,1220,1179,52179
Denmark,DNK,2010,2843,46158,139,122,1163,1134,51559
Denmark,DNK,2011,2810,45227,124,120,1110,1117,50508
Denmark,DNK,2012,2808,44888,119,116,1075,1075,50081
Denmark,DNK,2013,2823,44652,118,118,1051,1057,49819
Denmark,DNK,2014,2761,44333,115,126,1032,1053,49420
Denmark,DNK,2015,2782,44469,114,122,1017,1055,49559
Denmark,DNK,2016,2824,45311,119,119,1040,1064,50477
Denmark,DNK,2017,2862,46160,124,117,1056,1067,51386
Denmark,DNK,2018,2889,47020,126,114,1067,1075,52291
Denmark,DNK,2019,2929,47899,129,111,1069,1082,53219
Djibouti,DJI,1990,1517,845,730,613,114,104,3923
Djibouti,DJI,1991,1599,873,766,595,114,126,4073
Djibouti,DJI,1992,1638,916,734,591,119,402,4400
Djibouti,DJI,1993,1708,982,745,616,131,87,4269
Djibouti,DJI,1994,1777,1003,745,625,276,99,4525
Djibouti,DJI,1995,1773,1077,763,649,143,79,4484
Djibouti,DJI,1996,1828,1129,803,671,150,67,4648
Djibouti,DJI,1997,1993,1168,787,696,153,92,4889
Djibouti,DJI,1998,2037,1244,813,729,165,98,5086
Djibouti,DJI,1999,2169,1296,773,755,170,122,5285
Djibouti,DJI,2000,2305,1341,759,778,176,92,5451
Djibouti,DJI,2001,2421,1390,740,802,180,96,5629
Djibouti,DJI,2002,2513,1456,762,829,188,104,5852
Djibouti,DJI,2003,2683,1503,751,840,189,101,6067
Djibouti,DJI,2004,2670,1625,740,866,260,112,6273
Djibouti,DJI,2005,2701,1696,751,875,214,114,6351
Djibouti,DJI,2006,2814,1757,703,880,217,114,6485
Djibouti,DJI,2007,2762,1853,728,900,227,123,6593
Djibouti,DJI,2008,2754,1938,707,912,233,136,6680
Djibouti,DJI,2009,2823,2006,681,917,235,132,6794
Djibouti,DJI,2010,2823,2116,639,929,244,138,6889
Djibouti,DJI,2011,2762,2216,633,928,250,137,6926
Djibouti,DJI,2012,2708,2318,615,922,257,141,6961
Djibouti,DJI,2013,2722,2417,565,909,261,142,7016
Djibouti,DJI,2014,2782,2467,519,878,254,144,7044
Djibouti,DJI,2015,2699,2583,528,860,261,169,7100
Djibouti,DJI,2016,2691,2689,495,834,266,142,7117
Djibouti,DJI,2017,2610,2836,453,810,275,146,7130
Djibouti,DJI,2018,2501,2995,427,790,286,151,7150
Djibouti,DJI,2019,2472,3135,406,767,290,152,7222
Dominica,DMA,1990,46,550,8,19,25,12,660
Dominica,DMA,1991,45,562,8,18,25,13,671
Dominica,DMA,1992,45,553,7,18,25,12,660
Dominica,DMA,1993,47,556,7,17,25,12,664
Dominica,DMA,1994,48,562,7,17,25,12,671
Dominica,DMA,1995,48,566,7,16,27,12,676
Dominica,DMA,1996,48,569,7,16,24,12,676
Dominica,DMA,1997,47,564,7,15,23,11,667
Dominica,DMA,1998,46,563,6,15,25,12,667
Dominica,DMA,1999,48,575,6,15,25,12,681
Dominica,DMA,2000,50,577,6,14,25,12,684
Dominica,DMA,2001,50,572,5,14,24,11,676
Dominica,DMA,2002,48,578,5,13,24,12,680
Dominica,DMA,2003,48,580,5,13,26,12,684
Dominica,DMA,2004,46,572,5,13,25,12,673
Dominica,DMA,2005,44,565,5,13,24,12,663
Dominica,DMA,2006,44,565,5,12,24,13,663
Dominica,DMA,2007,44,567,5,12,29,13,670
Dominica,DMA,2008,43,565,5,12,22,13,660
Dominica,DMA,2009,41,566,5,12,22,14,660
Dominica,DMA,2010,42,572,4,12,25,14,669
Dominica,DMA,2011,42,576,4,13,22,13,670
Dominica,DMA,2012,42,581,4,13,22,13,675
Dominica,DMA,2013,41,586,4,13,22,13,679
Dominica,DMA,2014,43,592,4,13,22,13,687
Dominica,DMA,2015,43,596,4,13,58,13,727
Dominica,DMA,2016,42,596,4,13,22,13,690
Dominica,DMA,2017,41,598,4,12,86,13,754
Dominica,DMA,2018,41,602,4,12,22,13,694
Dominica,DMA,2019,41,607,4,12,22,13,699
Dominican Republic,DOM,1990,7516,18677,2552,5551,2249,961,37506
Dominican Republic,DOM,1991,7638,18775,2383,5480,2243,991,37510
Dominican Republic,DOM,1992,7635,18881,2124,5389,2227,1021,37277
Dominican Republic,DOM,1993,7739,19536,1929,5435,2320,1045,38004
Dominican Republic,DOM,1994,7795,19873,1730,5318,2353,1070,38139
Dominican Republic,DOM,1995,7923,20660,1556,5283,2466,1092,38980
Dominican Republic,DOM,1996,7950,22063,1392,5160,2590,1104,40259
Dominican Republic,DOM,1997,8040,23453,1270,5103,2692,1154,41712
Dominican Republic,DOM,1998,8041,24521,1141,4996,3150,1185,43034
Dominican Republic,DOM,1999,7988,25614,1052,4909,2842,1194,43599
Dominican Republic,DOM,2000,7889,26242,987,4902,2821,1224,44065
Dominican Republic,DOM,2001,7731,27189,935,4830,2846,1252,44783
Dominican Republic,DOM,2002,7565,28251,869,4538,2950,1299,45472
Dominican Republic,DOM,2003,7644,30417,868,4386,3089,1392,47796
Dominican Republic,DOM,2004,7744,33131,893,4387,3961,1503,51619
Dominican Republic,DOM,2005,7467,35065,861,4338,3512,1603,52846
Dominican Republic,DOM,2006,6984,36176,807,4327,3448,1721,53463
Dominican Republic,DOM,2007,6476,36852,757,4282,3616,1869,53852
Dominican Republic,DOM,2008,6031,37716,703,4034,3423,1941,53848
Dominican Republic,DOM,2009,5841,38941,688,4000,3412,2024,54906
Dominican Republic,DOM,2010,5791,39999,686,4031,3404,2073,55984
Dominican Republic,DOM,2011,5794,41123,700,4200,3452,2148,57417
Dominican Republic,DOM,2012,5878,43678,740,4343,3665,2269,60573
Dominican Republic,DOM,2013,5836,46778,792,4444,3928,2371,64149
Dominican Republic,DOM,2014,5753,49254,804,4164,4042,2440,66457
Dominican Republic,DOM,2015,5672,51644,837,4070,4124,2477,68824
Dominican Republic,DOM,2016,5529,52823,861,3950,4154,2458,69775
Dominican Republic,DOM,2017,5306,53082,873,3814,4022,2385,69482
Dominican Republic,DOM,2018,5087,53457,880,3678,3905,2316,69323
Dominican Republic,DOM,2019,4946,54065,890,3538,3802,2256,69497
Ecuador,ECU,1990,10629,26252,2251,4359,3767,1724,48982
Ecuador,ECU,1991,10739,28388,2270,4340,4131,1870,51738
Ecuador,ECU,1992,10219,28710,2210,4386,4192,1938,51655
Ecuador,ECU,1993,9820,28889,2153,4463,4617,2001,51943
Ecuador,ECU,1994,9013,29415,2134,4612,4238,2117,51529
Ecuador,ECU,1995,8518,29627,2146,4957,4276,2306,51830
Ecuador,ECU,1996,8438,31187,2243,5262,4472,2436,54038
Ecuador,ECU,1997,8042,30832,2256,5314,4496,2531,53471
Ecuador,ECU,1998,8426,32565,2353,5291,4618,2710,55963
Ecuador,ECU,1999,8968,33790,2355,5223,4452,2815,57603
Ecuador,ECU,2000,8785,34573,2350,5111,4558,2919,58296
Ecuador,ECU,2001,8305,34933,2229,4899,4693,3060,58119
Ecuador,ECU,2002,8285,39519,2253,4792,5224,3316,63389
Ecuador,ECU,2003,8246,42442,2151,4622,5471,3503,66435
Ecuador,ECU,2004,8245,44531,2029,4433,5727,3668,68633
Ecuador,ECU,2005,8376,47361,1923,4203,6174,3844,71881
Ecuador,ECU,2006,8430,49305,1806,4067,6441,3888,73937
Ecuador,ECU,2007,8248,50737,1690,3957,6720,3894,75246
Ecuador,ECU,2008,8179,52289,1585,3798,7154,3932,76937
Ecuador,ECU,2009,8086,53313,1469,3602,7249,3844,77563
Ecuador,ECU,2010,7995,54838,1411,3502,7427,3676,78849
Ecuador,ECU,2011,7580,55590,1321,3204,7355,3387,78437
Ecuador,ECU,2012,7660,58559,1314,3066,7388,3074,81061
Ecuador,ECU,2013,7812,60681,1330,2957,7110,2786,82676
Ecuador,ECU,2014,7856,61730,1324,2803,6936,2569,83218
Ecuador,ECU,2015,7689,61949,1285,2711,6890,2402,82926
Ecuador,ECU,2016,7800,64300,1303,2656,7565,2301,85925
Ecuador,ECU,2017,7943,66322,1326,2669,7030,2283,87573
Ecuador,ECU,2018,7997,67986,1348,2508,7092,2332,89263
Ecuador,ECU,2019,7993,68815,1350,2428,7261,2408,90255
Egypt,EGY,2008,43939,405518,1622,17099,30811,907,499896
Egypt,EGY,2009,43716,420534,1623,16117,31789,945,514724
Egypt,EGY,2010,42502,431198,1592,14380,32581,983,523236
Egypt,EGY,2011,42362,438513,1584,12444,33434,1099,529436
Egypt,EGY,2014,39498,467799,1519,7736,33775,1316,551643
Egypt,EGY,2015,40130,495190,1574,8045,34697,2211,581847
Egypt,EGY,2016,37269,505984,1536,7124,34556,1453,587922
Egypt,EGY,1990,101505,299825,2840,30455,33088,696,468409
Egypt,EGY,1991,94235,299329,2730,29177,31373,649,457493
Egypt,EGY,1992,87137,297922,2657,27988,30746,679,447129
Egypt,EGY,1993,80397,306681,2634,27043,30812,727,448294
Egypt,EGY,1994,73957,313652,2525,25786,31517,957,448394
Egypt,EGY,1995,68287,311659,2425,25094,30069,1018,438552
Egypt,EGY,1996,61587,314679,2243,23603,29619,887,432618
Egypt,EGY,1997,57918,322371,2143,22899,29605,860,435796
Egypt,EGY,1998,55375,327625,2078,22375,28881,653,436987
Egypt,EGY,1999,53634,331616,2013,22202,28853,628,438946
Egypt,EGY,2000,50906,326218,1862,21787,28031,622,429426
Egypt,EGY,2001,49881,345506,1872,21332,29025,651,448267
Egypt,EGY,2002,48656,362005,1837,20695,29472,701,463366
Egypt,EGY,2003,48249,380711,1869,20415,29820,709,481773
Egypt,EGY,2004,46707,384558,1791,20035,29653,798,483542
Egypt,EGY,2005,45393,384252,1721,19818,29579,895,481658
Egypt,EGY,2006,44521,389452,1665,19336,30058,831,485863
Egypt,EGY,2007,44370,392818,1628,18515,30090,845,488266
Egypt,EGY,2012,41887,455715,1597,10216,34216,1165,544796
Egypt,EGY,2013,41180,453585,1528,8783,33894,1282,540252
Egypt,EGY,2017,35461,507247,1476,6746,34813,2274,588017
Egypt,EGY,2018,34015,517347,1456,6391,34922,2486,596617
Egypt,EGY,2019,32913,528034,1450,6087,35063,1647,605194
El Salvador,SLV,1990,5104,14853,875,3181,2286,4587,30886
El Salvador,SLV,1991,5077,15057,832,3047,2285,4775,31073
El Salvador,SLV,1992,4852,15746,795,2915,2284,3775,30367
El Salvador,SLV,1993,4711,16366,753,2756,2388,3977,30951
El Salvador,SLV,1994,4651,16933,727,2589,2460,4226,31586
El Salvador,SLV,1995,4470,16772,681,2418,2423,4253,31017
El Salvador,SLV,1996,4376,16905,663,2288,2338,4156,30726
El Salvador,SLV,1997,4330,17669,676,2122,2445,4239,31481
El Salvador,SLV,1998,4328,19004,707,1961,3124,4338,33462
El Salvador,SLV,1999,4034,18395,676,1754,2459,3933,31251
El Salvador,SLV,2000,3879,18731,665,1579,2476,3831,31161
El Salvador,SLV,2001,3745,18950,647,1397,3536,3673,31948
El Salvador,SLV,2002,3581,18782,619,1270,2232,3556,30040
El Salvador,SLV,2003,3583,19767,627,1173,2278,3709,31137
El Salvador,SLV,2004,3604,20881,644,1101,2336,3922,32488
El Salvador,SLV,2005,3523,21487,645,1029,2489,4073,33246
El Salvador,SLV,2006,3490,22017,645,968,2298,4207,33625
El Salvador,SLV,2007,3456,22223,631,906,2182,4170,33568
El Salvador,SLV,2008,3377,22167,609,880,2067,4077,33177
El Salvador,SLV,2009,3449,23628,629,897,2491,4163,35257
El Salvador,SLV,2010,3246,23002,589,866,1969,3966,33638
El Salvador,SLV,2011,3236,24074,583,873,1998,3967,34731
El Salvador,SLV,2012,3116,23404,540,870,1719,6900,36549
El Salvador,SLV,2013,3275,24949,553,856,1770,6713,38116
El Salvador,SLV,2014,3492,27131,581,784,2016,7010,41014
El Salvador,SLV,2015,3511,27607,583,722,2082,7411,41916
El Salvador,SLV,2016,3478,27775,573,668,2061,4064,38619
El Salvador,SLV,2017,3459,28246,575,613,2070,4027,38990
El Salvador,SLV,2018,3434,28704,579,567,2081,4025,39390
El Salvador,SLV,2019,3439,29386,584,527,2065,3946,39947
Equatorial Guinea,GNQ,2007,3303,1656,112,724,294,51,6140
Equatorial Guinea,GNQ,2010,3353,1813,86,657,305,55,6269
Equatorial Guinea,GNQ,2014,3431,2051,67,615,322,63,6549
Equatorial Guinea,GNQ,1990,3583,1535,416,604,285,51,6474
Equatorial Guinea,GNQ,1991,3723,1542,428,626,294,51,6664
Equatorial Guinea,GNQ,1992,3830,1538,430,641,298,53,6790
Equatorial Guinea,GNQ,1993,3953,1551,431,660,307,52,6954
Equatorial Guinea,GNQ,1994,4061,1561,427,678,310,52,7089
Equatorial Guinea,GNQ,1995,4181,1587,423,701,322,55,7269
Equatorial Guinea,GNQ,1996,4178,1612,400,750,329,55,7324
Equatorial Guinea,GNQ,1997,3922,1561,340,758,316,53,6950
Equatorial Guinea,GNQ,1998,3787,1544,297,773,315,58,6774
Equatorial Guinea,GNQ,1999,3678,1543,268,787,320,51,6647
Equatorial Guinea,GNQ,2000,3536,1535,242,796,318,49,6476
Equatorial Guinea,GNQ,2001,3386,1505,201,771,299,47,6209
Equatorial Guinea,GNQ,2002,3305,1476,173,750,280,46,6030
Equatorial Guinea,GNQ,2003,3347,1500,152,746,279,47,6071
Equatorial Guinea,GNQ,2004,3317,1537,140,741,281,59,6075
Equatorial Guinea,GNQ,2005,3330,1572,134,748,288,49,6121
Equatorial Guinea,GNQ,2006,3289,1624,124,733,294,51,6115
Equatorial Guinea,GNQ,2008,3281,1696,98,707,291,52,6125
Equatorial Guinea,GNQ,2009,3206,1755,90,675,299,58,6083
Equatorial Guinea,GNQ,2011,3609,1908,84,674,320,58,6653
Equatorial Guinea,GNQ,2012,3678,1964,78,677,322,60,6779
Equatorial Guinea,GNQ,2013,3477,1998,72,637,318,60,6562
Equatorial Guinea,GNQ,2015,3624,2138,66,599,334,66,6827
Equatorial Guinea,GNQ,2016,3630,2257,62,574,351,70,6944
Equatorial Guinea,GNQ,2017,3494,2353,60,538,360,73,6878
Equatorial Guinea,GNQ,2018,3502,2448,60,521,378,76,6985
Equatorial Guinea,GNQ,2019,3621,2522,60,509,387,80,7179
Eritrea,ERI,1990,18532,7139,8997,3585,1045,10750,50048
Eritrea,ERI,1991,17913,7098,7744,3493,1031,10752,48031
Eritrea,ERI,1992,17960,7346,6846,3585,1058,361,37156
Eritrea,ERI,1993,18297,7678,6447,3711,1101,407,37641
Eritrea,ERI,1994,18692,8157,5918,3845,1155,415,38182
Eritrea,ERI,1995,19014,8766,5592,3933,1248,458,39011
Eritrea,ERI,1996,19282,8954,5253,3967,1263,497,39216
Eritrea,ERI,1997,19355,9188,4864,4012,1292,531,39242
Eritrea,ERI,1998,19651,9298,4432,4021,1291,1391,40084
Eritrea,ERI,1999,19422,9565,4283,4067,1336,19625,58298
Eritrea,ERI,2000,19494,9880,4018,4136,1379,2354,41261
Eritrea,ERI,2001,20262,10158,3833,4220,1398,592,40463
Eritrea,ERI,2002,20070,10884,3857,4415,1525,658,41409
Eritrea,ERI,2003,20146,11319,3718,4500,1575,762,42020
Eritrea,ERI,2004,20338,11769,3850,4562,1645,776,42940
Eritrea,ERI,2005,20240,12102,3705,4588,1679,902,43216
Eritrea,ERI,2006,19921,12441,3582,4606,1704,760,43014
Eritrea,ERI,2007,19689,12778,3425,4613,1730,782,43017
Eritrea,ERI,2008,19292,13168,3333,4638,1765,1054,43250
Eritrea,ERI,2009,18820,13473,3112,4621,1770,836,42632
Eritrea,ERI,2010,18877,13769,2940,4595,1785,844,42810
Eritrea,ERI,2011,18636,14055,2852,4545,1788,866,42742
Eritrea,ERI,2012,18059,14428,2707,4493,1812,871,42370
Eritrea,ERI,2013,17769,14802,2563,4428,1842,890,42294
Eritrea,ERI,2014,17362,15123,2471,4352,1856,912,42076
Eritrea,ERI,2015,16779,15577,2401,4295,1889,930,41871
Eritrea,ERI,2016,16658,15980,2327,4212,1913,972,42062
Eritrea,ERI,2017,16391,16452,2219,4124,1935,966,42087
Eritrea,ERI,2018,16057,16985,2107,4064,1971,997,42181
Eritrea,ERI,2019,15888,17548,2057,4026,2020,1033,42572
Estonia,EST,1990,324,16043,28,145,1272,610,18422
Estonia,EST,1991,345,16503,27,130,1346,669,19020
Estonia,EST,1992,357,16191,23,123,1327,769,18790
Estonia,EST,1993,415,17127,21,108,1458,897,20026
Estonia,EST,1994,487,17930,18,99,1608,981,21123
Estonia,EST,1995,498,16930,16,92,1484,929,19949
Estonia,EST,1996,447,15228,12,69,1213,814,17783
Estonia,EST,1997,451,15209,12,60,1176,780,17688
Estonia,EST,1998,476,15933,10,54,1173,828,18474
Estonia,EST,1999,449,15319,10,53,1069,802,17702
Estonia,EST,2000,448,15356,8,52,1001,806,17671
Estonia,EST,2001,459,15805,8,45,1024,869,18210
Estonia,EST,2002,430,15464,7,39,958,811,17709
Estonia,EST,2003,397,15276,6,41,872,778,17370
Estonia,EST,2004,383,15105,6,39,826,745,17104
Estonia,EST,2005,358,14955,5,36,767,731,16852
Estonia,EST,2006,358,14924,6,33,747,699,16767
Estonia,EST,2007,343,15143,6,32,732,690,16946
Estonia,EST,2008,316,14506,5,29,629,614,16099
Estonia,EST,2009,307,14232,4,25,567,575,15710
Estonia,EST,2010,282,13540,3,23,499,520,14867
Estonia,EST,2011,301,13810,4,19,494,526,15154
Estonia,EST,2012,298,13828,3,18,477,533,15157
Estonia,EST,2013,299,13631,3,15,427,468,14843
Estonia,EST,2014,307,13911,3,14,427,452,15114
Estonia,EST,2015,299,13706,3,14,397,430,14849
Estonia,EST,2016,303,14224,3,14,392,436,15372
Estonia,EST,2017,298,14357,3,13,395,451,15517
Estonia,EST,2018,295,14502,3,11,392,463,15666
Estonia,EST,2019,291,14570,3,11,386,459,15720
Eswatini,SWZ,1990,1966,2174,343,654,369,222,5728
Eswatini,SWZ,1991,1997,2239,338,650,380,216,5820
Eswatini,SWZ,1992,2127,2275,330,646,386,210,5974
Eswatini,SWZ,1993,2325,2306,318,644,392,205,6190
Eswatini,SWZ,1994,2740,2390,304,646,406,202,6688
Eswatini,SWZ,1995,3371,2525,292,649,429,209,7475
Eswatini,SWZ,1996,4218,2672,276,655,461,216,8498
Eswatini,SWZ,1997,5214,2765,262,658,480,222,9601
Eswatini,SWZ,1998,6422,2940,252,661,519,232,11026
Eswatini,SWZ,1999,7687,3133,252,665,562,234,12533
Eswatini,SWZ,2000,9060,3420,252,670,626,236,14264
Eswatini,SWZ,2001,10388,3656,255,671,675,243,15888
Eswatini,SWZ,2002,11405,3884,258,672,718,243,17180
Eswatini,SWZ,2003,12419,4040,265,665,753,244,18386
Eswatini,SWZ,2004,13144,4151,266,665,777,249,19252
Eswatini,SWZ,2005,13150,4216,267,659,786,256,19334
Eswatini,SWZ,2006,12574,4189,267,643,784,257,18714
Eswatini,SWZ,2007,12070,4190,268,641,790,263,18222
Eswatini,SWZ,2008,11620,4208,264,640,791,268,17791
Eswatini,SWZ,2009,11110,4223,256,642,794,269,17294
Eswatini,SWZ,2010,10110,4178,248,623,779,270,16208
Eswatini,SWZ,2011,9083,4120,242,586,766,268,15065
Eswatini,SWZ,2012,8522,4126,234,570,762,271,14485
Eswatini,SWZ,2013,7914,4124,224,546,751,270,13829
Eswatini,SWZ,2014,7206,4126,220,528,755,271,13106
Eswatini,SWZ,2015,6559,4138,212,511,736,273,12429
Eswatini,SWZ,2016,6048,4163,198,495,727,272,11903
Eswatini,SWZ,2017,5672,4210,195,479,727,274,11557
Eswatini,SWZ,2018,5376,4283,188,470,728,278,11323
Eswatini,SWZ,2019,5248,4377,182,466,728,282,11283
Ethiopia,ETH,2007,304974,172131,43215,112345,20218,11792,664675
Ethiopia,ETH,2008,281648,172426,39168,110997,19905,11259,635403
Ethiopia,ETH,2009,267823,173313,35047,108909,19509,12262,616863
Ethiopia,ETH,1990,349946,167310,83588,107719,23273,61218,793054
Ethiopia,ETH,1991,362545,169060,84624,108840,23395,24091,772555
Ethiopia,ETH,1992,372841,172731,87265,111026,23951,13417,781231
Ethiopia,ETH,1993,384541,174718,87632,112713,24102,12015,795721
Ethiopia,ETH,1994,398421,175853,87241,114215,23971,12459,812160
Ethiopia,ETH,1995,409698,176638,86612,115010,23842,13469,825269
Ethiopia,ETH,1996,413961,175861,84437,115087,23453,12135,824934
Ethiopia,ETH,1997,414636,176047,81984,115160,23386,12014,823227
Ethiopia,ETH,1998,413224,177526,80560,115989,23051,13102,823452
Ethiopia,ETH,1999,408924,177855,78227,116311,22728,48937,852982
Ethiopia,ETH,2000,410311,175058,73577,115427,22181,60211,856765
Ethiopia,ETH,2001,408683,172882,69234,114409,21597,11718,798523
Ethiopia,ETH,2002,396393,172201,64306,114287,21258,12509,780954
Ethiopia,ETH,2003,387115,171965,58451,114291,21053,12247,765122
Ethiopia,ETH,2004,375770,172119,52466,113812,20642,11704,746513
Ethiopia,ETH,2005,350313,172620,50957,114476,20966,11390,720722
Ethiopia,ETH,2006,327049,172328,46666,113560,21355,11499,692457
Ethiopia,ETH,2010,251003,174117,31557,106521,19038,11305,593541
Ethiopia,ETH,2011,233967,177579,29991,104701,18792,10914,575944
Ethiopia,ETH,2012,223788,180486,27252,101908,18285,11256,562975
Ethiopia,ETH,2013,215543,184366,24791,99307,17690,10939,552636
Ethiopia,ETH,2014,205534,189406,24284,97506,17885,10832,545447
Ethiopia,ETH,2015,198296,193740,22266,94924,17715,11105,538046
Ethiopia,ETH,2016,189530,199413,20572,92729,18073,11613,531930
Ethiopia,ETH,2017,186661,205856,20298,90372,18383,11680,533250
Ethiopia,ETH,2018,183272,212520,19031,87855,18624,11912,533214
Ethiopia,ETH,2019,179552,218655,17592,85070,18713,11521,531103
Fiji,FJI,1990,417,3351,42,227,257,32,4326
Fiji,FJI,1991,417,3446,42,224,256,31,4416
Fiji,FJI,1992,410,3533,42,212,254,33,4484
Fiji,FJI,1993,416,3643,43,219,277,32,4630
Fiji,FJI,1994,415,3747,43,220,256,34,4715
Fiji,FJI,1995,413,3860,44,218,256,35,4826
Fiji,FJI,1996,418,3987,44,221,259,36,4965
Fiji,FJI,1997,412,4072,44,222,284,39,5073
Fiji,FJI,1998,410,4020,46,225,254,41,4996
Fiji,FJI,1999,419,4297,46,225,279,45,5311
Fiji,FJI,2000,420,4483,46,224,283,55,5511
Fiji,FJI,2001,410,4422,44,226,275,49,5426
Fiji,FJI,2002,399,4417,42,226,270,49,5403
Fiji,FJI,2003,398,4566,42,228,283,48,5565
Fiji,FJI,2004,393,4486,41,227,278,45,5470
Fiji,FJI,2005,397,4646,40,219,268,47,5617
Fiji,FJI,2006,403,4809,38,215,273,45,5783
Fiji,FJI,2007,409,4998,36,213,275,45,5976
Fiji,FJI,2008,407,5158,36,209,273,44,6127
Fiji,FJI,2009,401,5134,36,204,271,44,6090
Fiji,FJI,2010,404,5253,36,199,259,44,6195
Fiji,FJI,2011,403,5381,36,193,259,44,6316
Fiji,FJI,2012,397,5494,36,190,281,45,6443
Fiji,FJI,2013,394,5599,36,186,266,45,6526
Fiji,FJI,2014,393,5721,36,183,264,44,6641
Fiji,FJI,2015,395,5839,36,182,261,45,6758
Fiji,FJI,2016,395,5943,36,180,309,45,6908
Fiji,FJI,2017,393,6060,37,174,260,44,6968
Fiji,FJI,2018,389,6162,37,168,266,44,7066
Fiji,FJI,2019,388,6266,37,165,259,43,7158
Finland,FIN,1990,2859,41140,11,168,2634,657,47469
Finland,FIN,1991,2887,40991,9,168,2587,670,47312
Finland,FIN,1992,2988,41415,8,154,2495,693,47753
Finland,FIN,1993,3095,41437,9,137,2385,716,47779
Finland,FIN,1994,3024,40260,9,133,2290,758,46474
Finland,FIN,1995,3089,40658,10,118,2250,821,46946
Finland,FIN,1996,3207,40697,10,109,2168,931,47122
Finland,FIN,1997,3196,40906,10,105,2143,997,47357
Finland,FIN,1998,3180,40788,10,100,2068,1065,47211
Finland,FIN,1999,3159,40685,11,95,2041,1149,47140
Finland,FIN,2000,3053,40882,11,91,2001,1188,47226
Finland,FIN,2001,2765,40941,12,83,1937,1207,46945
Finland,FIN,2002,2520,41463,12,80,1863,1212,47150
Finland,FIN,2003,2185,41680,11,85,1812,1222,46995
Finland,FIN,2004,1790,41719,12,92,1782,1280,46675
Finland,FIN,2005,1448,42069,12,85,1738,1289,46641
Finland,FIN,2006,1206,42403,12,78,1707,1301,46707
Finland,FIN,2007,1073,43148,13,76,1706,1315,47331
Finland,FIN,2008,947,43613,13,76,1664,1296,47609
Finland,FIN,2009,876,44245,14,69,1630,1261,48095
Finland,FIN,2010,820,45032,15,65,1580,1216,48728
Finland,FIN,2011,775,45452,15,62,1508,1183,48995
Finland,FIN,2012,747,46091,15,60,1445,1138,49496
Finland,FIN,2013,731,46687,16,49,1387,1100,49970
Finland,FIN,2014,722,47089,15,52,1319,1065,50262
Finland,FIN,2015,728,47505,17,44,1263,1033,50590
Finland,FIN,2016,748,48338,17,44,1261,1016,51424
Finland,FIN,2017,811,49193,17,42,1268,1036,52367
Finland,FIN,2018,859,50011,17,41,1280,1042,53250
Finland,FIN,2019,904,50871,18,40,1313,1048,54194
France,FRA,1990,24655,422849,5041,2123,29210,5512,489390
France,FRA,1991,25995,421016,5181,2101,28688,5498,488479
France,FRA,1992,27075,420208,5337,1947,28024,5360,487951
France,FRA,1993,28223,422969,5478,1810,27699,5332,491511
France,FRA,1994,28741,420959,5573,1742,27130,5356,489501
France,FRA,1995,29266,424756,5747,1641,26571,5319,493300
France,FRA,1996,28671,428444,5885,1624,25996,5242,495862
France,FRA,1997,26553,427051,5961,1626,25510,5228,491929
France,FRA,1998,26315,432646,6060,1617,25448,5267,497353
France,FRA,1999,25967,433973,6158,1619,24962,5413,498092
France,FRA,2000,25109,430901,6302,1703,24092,5594,493701
France,FRA,2001,24172,432169,6399,1724,23738,5759,493961
France,FRA,2002,24043,436147,6548,1649,23209,5875,497471
France,FRA,2003,23751,437878,6710,1614,22465,7608,500026
France,FRA,2004,22392,425446,6409,1563,21193,5957,482960
France,FRA,2005,22335,426728,6466,1514,20835,6086,483964
France,FRA,2006,21835,426552,6514,1534,20288,6315,483038
France,FRA,2007,21773,428936,6648,1517,19955,6195,485024
France,FRA,2008,21980,435738,6906,1529,19901,6367,492421
France,FRA,2009,22051,441087,7093,1533,19989,6611,498364
France,FRA,2010,21810,443454,7251,1540,19766,6643,500464
France,FRA,2011,21697,447435,7347,1465,19174,6619,503737
France,FRA,2012,22260,454834,7590,1473,18434,6774,511365
France,FRA,2013,22334,456996,7653,1486,17806,6565,512840
France,FRA,2014,22037,456802,7642,1441,17178,6448,511548
France,FRA,2015,23363,470819,8027,1429,17259,6820,527717
France,FRA,2016,23735,471800,8228,1379,16685,6642,528469
France,FRA,2017,24698,484032,8619,1283,16800,6551,541983
France,FRA,2018,25592,494130,8993,1231,16859,6639,553444
France,FRA,2019,26458,505865,9315,1188,16878,8213,567917
Gabon,GAB,1990,3563,4280,265,917,529,96,9650
Gabon,GAB,1991,3621,4329,255,921,540,98,9764
Gabon,GAB,1992,3732,4387,248,921,549,100,9937
Gabon,GAB,1993,3799,4426,241,918,541,98,10023
Gabon,GAB,1994,3947,4548,236,925,557,101,10314
Gabon,GAB,1995,4134,4704,231,935,588,104,10696
Gabon,GAB,1996,4293,4807,225,938,597,104,10964
Gabon,GAB,1997,4484,4838,218,942,607,114,11203
Gabon,GAB,1998,4693,4890,214,944,616,107,11464
Gabon,GAB,1999,4885,4929,214,948,615,106,11697
Gabon,GAB,2000,5081,5041,218,951,637,105,12033
Gabon,GAB,2001,5264,5149,216,944,660,108,12341
Gabon,GAB,2002,5328,5159,213,937,666,110,12413
Gabon,GAB,2003,5352,5272,212,934,684,113,12567
Gabon,GAB,2004,5169,5334,211,931,687,113,12445
Gabon,GAB,2005,4839,5332,212,924,699,115,12121
Gabon,GAB,2006,4617,5430,209,923,708,118,12005
Gabon,GAB,2007,4589,5491,204,913,730,123,12050
Gabon,GAB,2008,4627,5610,198,901,745,124,12205
Gabon,GAB,2009,4600,5617,190,883,746,127,12163
Gabon,GAB,2010,4499,5578,176,857,728,125,11963
Gabon,GAB,2011,4474,5661,168,830,725,125,11983
Gabon,GAB,2012,4289,5693,156,786,720,125,11769
Gabon,GAB,2013,4020,5714,148,739,710,124,11455
Gabon,GAB,2014,3874,5790,143,710,717,126,11360
Gabon,GAB,2015,3772,5918,141,683,723,129,11366
Gabon,GAB,2016,3665,6057,138,657,729,131,11377
Gabon,GAB,2017,3554,6218,135,631,736,131,11405
Gabon,GAB,2018,3441,6352,133,608,743,134,11411
Gabon,GAB,2019,3364,6476,131,587,746,136,11440
Gambia,GMB,2007,5352,4186,360,1916,394,66,12274
Gambia,GMB,2008,5547,4177,328,1863,382,64,12361
Gambia,GMB,2009,5272,4350,310,1844,397,64,12237
Gambia,GMB,2012,5582,4409,249,1681,368,67,12356
Gambia,GMB,1990,3924,2079,519,1597,225,37,8381
Gambia,GMB,1991,3972,2174,525,1644,236,39,8590
Gambia,GMB,1992,3954,2302,560,1691,250,41,8798
Gambia,GMB,1993,4193,2329,548,1710,250,41,9071
Gambia,GMB,1994,4411,2399,520,1734,253,55,9372
Gambia,GMB,1995,4170,2650,553,1789,284,48,9494
Gambia,GMB,1996,4660,2601,490,1785,270,45,9851
Gambia,GMB,1997,4912,2708,472,1807,280,48,10227
Gambia,GMB,1998,4735,2904,468,1837,299,52,10295
Gambia,GMB,1999,4554,3161,476,1872,383,56,10502
Gambia,GMB,2000,5040,3112,420,1853,308,55,10788
Gambia,GMB,2001,5285,3154,385,1857,309,54,11044
Gambia,GMB,2002,5367,3303,365,1874,316,53,11278
Gambia,GMB,2003,5311,3484,356,1906,336,57,11450
Gambia,GMB,2004,5286,3850,420,1943,383,65,11947
Gambia,GMB,2005,5237,4025,410,1952,400,78,12102
Gambia,GMB,2006,5351,4077,379,1934,390,66,12197
Gambia,GMB,2010,5243,4418,293,1801,400,64,12219
Gambia,GMB,2011,5610,4268,252,1724,356,58,12268
Gambia,GMB,2013,5478,4601,243,1652,381,62,12417
Gambia,GMB,2014,5087,4974,252,1639,414,67,12433
Gambia,GMB,2015,5210,5005,235,1574,403,65,12492
Gambia,GMB,2016,4852,5314,238,1547,431,70,12452
Gambia,GMB,2017,4510,5671,252,1517,463,77,12490
Gambia,GMB,2018,4516,5774,235,1469,464,73,12531
Gambia,GMB,2019,4446,5922,224,1434,470,74,12570
Georgia,GEO,1990,2650,51067,19,1571,2496,632,58435
Georgia,GEO,1991,2497,51877,20,1490,2539,691,59114
Georgia,GEO,1992,2357,52458,19,1412,2566,1400,60212
Georgia,GEO,1993,2144,50919,16,1377,2374,2630,59460
Georgia,GEO,1994,1974,50985,16,1324,2180,541,57020
Georgia,GEO,1995,1808,46601,13,1270,1914,467,52073
Georgia,GEO,1996,1682,44279,10,1213,1619,371,49174
Georgia,GEO,1997,1609,45667,10,1178,1506,427,50397
Georgia,GEO,1998,1543,47600,7,1134,1413,616,52313
Georgia,GEO,1999,1486,49205,6,1086,1367,439,53589
Georgia,GEO,2000,1455,50301,7,1047,1279,389,54478
Georgia,GEO,2001,1362,50387,5,1006,1264,459,54483
Georgia,GEO,2002,1283,52782,5,982,1285,526,56863
Georgia,GEO,2003,1176,53936,4,951,1196,379,57642
Georgia,GEO,2004,1100,54363,3,934,1186,376,57962
Georgia,GEO,2005,1021,53076,3,873,1125,397,56495
Georgia,GEO,2006,970,51254,3,781,1129,354,54491
Georgia,GEO,2007,921,48294,4,739,1138,323,51419
Georgia,GEO,2008,953,48034,4,709,1242,934,51876
Georgia,GEO,2009,967,49312,4,687,1311,283,52564
Georgia,GEO,2010,1011,50162,7,618,1305,302,53405
Georgia,GEO,2011,1037,50046,10,574,1298,280,53245
Georgia,GEO,2012,1097,48869,14,531,1305,301,52117
Georgia,GEO,2013,1083,47490,17,493,1327,243,50653
Georgia,GEO,2014,1124,46907,19,448,1353,259,50110
Georgia,GEO,2015,1162,46989,19,411,1358,258,50197
Georgia,GEO,2016,1114,48015,17,384,1320,240,51090
Georgia,GEO,2017,1081,47930,16,353,1289,240,50909
Georgia,GEO,2018,1044,47511,14,324,1240,238,50371
Georgia,GEO,2019,1007,47064,14,297,1204,237,49823
Germany,DEU,1990,24112,825670,318,2778,29212,8066,890156
Germany,DEU,1991,23387,817674,273,2441,29177,8572,881524
Germany,DEU,1992,22691,804362,251,2197,28394,8967,866862
Germany,DEU,1993,22671,804426,235,2044,27671,9213,866260
Germany,DEU,1994,22654,803236,233,1934,27103,9425,864585
Germany,DEU,1995,22385,803835,248,1892,26617,9534,864511
Germany,DEU,1996,21765,799422,245,1885,25926,9528,858771
Germany,DEU,1997,20685,787309,247,1860,24863,9394,844358
Germany,DEU,1998,20192,778730,237,1761,23611,9270,833801
Germany,DEU,1999,20380,778259,238,1729,22873,9084,832563
Germany,DEU,2000,20398,776782,250,1672,22079,8760,829941
Germany,DEU,2001,20406,772880,273,1607,21244,8463,824873
Germany,DEU,2002,21178,779197,302,1556,20809,8327,831369
Germany,DEU,2003,22007,780158,352,1550,20360,8169,832596
Germany,DEU,2004,22181,768308,402,1519,19355,7989,819754
Germany,DEU,2005,23137,768090,470,1434,18610,7862,819603
Germany,DEU,2006,23720,763956,538,1406,17939,7830,815389
Germany,DEU,2007,24570,763972,610,1414,17521,7801,815888
Germany,DEU,2008,25359,767162,693,1326,17280,7872,819692
Germany,DEU,2009,26122,772743,778,1285,17220,7965,826113
Germany,DEU,2010,26455,773156,884,1269,17126,8086,826976
Germany,DEU,2011,26518,770815,970,1258,16957,8085,824603
Germany,DEU,2012,27071,780575,1080,1196,16772,8178,834872
Germany,DEU,2013,27865,796139,1202,1210,16869,8322,851607
Germany,DEU,2014,27939,799675,1319,1234,16734,8453,855354
Germany,DEU,2015,29540,828721,1506,1288,17163,8704,886922
Germany,DEU,2016,29741,838278,1565,1361,17134,8872,896951
Germany,DEU,2017,29610,841599,1451,1244,17170,8857,899931
Germany,DEU,2018,29900,853508,1413,1190,17222,8886,912119
Germany,DEU,2019,30528,872465,1398,1133,17276,8923,931723
Ghana,GHA,1990,69070,40541,8578,16051,4336,889,139465
Ghana,GHA,1991,69253,41655,8292,16271,4419,940,140830
Ghana,GHA,1992,70035,43024,8155,16538,4470,1005,143227
Ghana,GHA,1993,70585,44191,8072,16875,4555,973,145251
Ghana,GHA,1994,71978,45351,7925,17170,4628,3024,150076
Ghana,GHA,1995,73508,46542,7773,17531,4861,1208,151423
Ghana,GHA,1996,75325,48158,7687,18008,4787,1094,155059
Ghana,GHA,1997,78968,50362,7650,18460,4988,1149,161577
Ghana,GHA,1998,79510,51841,7565,18880,5051,1198,164045
Ghana,GHA,1999,81535,53586,7483,19329,5268,1244,168445
Ghana,GHA,2000,83935,55511,7399,19738,5326,1357,173266
Ghana,GHA,2001,86766,57452,7341,20069,5627,1412,178667
Ghana,GHA,2002,89578,59381,7371,20217,5903,1429,183879
Ghana,GHA,2003,93731,60920,7625,20432,6262,1467,190437
Ghana,GHA,2004,94948,62684,7566,20706,6537,1507,193948
Ghana,GHA,2005,95368,64712,7413,21127,6828,1549,196997
Ghana,GHA,2006,95307,66803,7149,21492,6988,1582,199321
Ghana,GHA,2007,95822,68648,6841,21690,7336,1587,201924
Ghana,GHA,2008,95481,70185,6208,21414,7290,1625,202203
Ghana,GHA,2009,94820,72055,5826,21117,7479,1560,202857
Ghana,GHA,2010,93087,74133,5432,20864,7650,1547,202713
Ghana,GHA,2011,90058,76372,5200,20562,7835,1559,201586
Ghana,GHA,2012,86802,78127,4954,20093,7967,1577,199520
Ghana,GHA,2013,85276,79917,4784,19529,8135,1602,199243
Ghana,GHA,2014,84480,81990,4779,19044,8421,1636,200350
Ghana,GHA,2015,82284,84821,4769,18933,8929,1674,201410
Ghana,GHA,2016,79372,87628,4706,18879,9089,1709,201383
Ghana,GHA,2017,76683,90405,4560,18804,9262,1743,201457
Ghana,GHA,2018,75018,91607,4050,18040,9084,1656,199455
Ghana,GHA,2019,73081,93735,3831,17532,9028,1647,198854
Greece,GRC,1990,2233,84056,23,505,3233,288,90338
Greece,GRC,1991,2275,85639,24,465,3252,333,91988
Greece,GRC,1992,2390,87487,25,441,3270,331,93944
Greece,GRC,1993,2419,87745,25,437,3254,349,94229
Greece,GRC,1994,2502,88842,25,429,3291,380,95469
Greece,GRC,1995,2594,90143,24,413,3330,419,96923
Greece,GRC,1996,2702,90906,23,388,3331,470,97820
Greece,GRC,1997,2774,91144,22,362,3272,502,98076
Greece,GRC,1998,2989,92619,20,353,3247,517,99745
Greece,GRC,1999,3106,93832,18,329,3317,535,101137
Greece,GRC,2000,3264,94202,17,293,3112,576,101464
Greece,GRC,2001,3291,94352,16,270,3000,573,101502
Greece,GRC,2002,3379,94575,15,262,2865,531,101627
Greece,GRC,2003,3437,94927,14,231,2826,539,101974
Greece,GRC,2004,3420,94591,12,228,2837,533,101621
Greece,GRC,2005,3390,94311,11,215,2799,555,101281
Greece,GRC,2006,3290,94779,11,204,2733,545,101562
Greece,GRC,2007,3169,97660,9,199,2871,592,104500
Greece,GRC,2008,3272,97344,9,182,2693,566,104066
Greece,GRC,2009,3115,97986,9,193,2669,567,104539
Greece,GRC,2010,3207,98363,9,197,2561,543,104880
Greece,GRC,2011,3458,100998,9,176,2494,515,107650
Greece,GRC,2012,3792,103550,9,158,2434,496,110439
Greece,GRC,2013,4126,102572,10,167,2306,447,109628
Greece,GRC,2014,4917,102599,10,182,2239,420,110367
Greece,GRC,2015,5586,104864,12,187,2260,403,113312
Greece,GRC,2016,5988,106725,12,201,2247,468,115641
Greece,GRC,2017,5918,109402,12,171,2250,397,118150
Greece,GRC,2018,6146,114487,12,157,2354,410,123566
Greece,GRC,2019,6229,117528,14,144,2259,403,126577
Greenland,GRL,1990,25,269,0,19,67,25,405
Greenland,GRL,1991,26,272,0,19,67,25,409
Greenland,GRL,1992,26,275,0,18,67,25,411
Greenland,GRL,1993,25,291,0,17,68,25,426
Greenland,GRL,1994,26,296,0,16,68,25,431
Greenland,GRL,1995,26,301,0,14,68,25,434
Greenland,GRL,1996,26,303,0,13,67,24,433
Greenland,GRL,1997,24,307,0,12,67,24,434
Greenland,GRL,1998,23,307,0,11,65,24,430
Greenland,GRL,1999,23,308,0,10,64,24,429
Greenland,GRL,2000,21,309,0,9,62,25,426
Greenland,GRL,2001,21,311,0,8,61,24,425
Greenland,GRL,2002,21,315,0,8,60,24,428
Greenland,GRL,2003,21,312,0,7,60,25,425
Greenland,GRL,2004,19,298,0,7,57,25,406
Greenland,GRL,2005,19,302,0,6,57,25,409
Greenland,GRL,2006,19,309,0,6,56,25,415
Greenland,GRL,2007,18,314,1,6,56,24,419
Greenland,GRL,2008,18,317,1,5,54,23,418
Greenland,GRL,2009,19,320,1,5,53,22,420
Greenland,GRL,2010,19,325,2,5,53,22,426
Greenland,GRL,2011,19,331,2,5,52,21,430
Greenland,GRL,2012,19,333,2,5,50,21,430
Greenland,GRL,2013,18,338,2,4,49,20,431
Greenland,GRL,2014,18,341,2,4,47,20,432
Greenland,GRL,2015,18,342,2,4,45,19,430
Greenland,GRL,2016,19,352,2,4,45,18,440
Greenland,GRL,2017,19,359,2,4,44,18,446
Greenland,GRL,2018,19,365,2,4,43,18,451
Greenland,GRL,2019,19,371,2,4,41,18,455
Grenada,GRD,1990,75,641,11,24,28,7,786
Grenada,GRD,1991,69,620,11,23,28,7,758
Grenada,GRD,1992,69,616,10,22,27,11,755
Grenada,GRD,1993,71,614,9,21,27,8,750
Grenada,GRD,1994,69,594,9,21,26,7,726
Grenada,GRD,1995,66,570,8,21,24,7,696
Grenada,GRD,1996,64,548,8,20,25,8,673
Grenada,GRD,1997,62,532,8,20,26,8,656
Grenada,GRD,1998,62,526,7,20,25,9,649
Grenada,GRD,1999,65,539,7,19,25,10,665
Grenada,GRD,2000,65,541,6,19,25,13,669
Grenada,GRD,2001,67,544,6,18,25,9,669
Grenada,GRD,2002,66,548,6,18,26,10,674
Grenada,GRD,2003,65,548,6,17,26,10,672
Grenada,GRD,2004,63,553,6,16,44,9,691
Grenada,GRD,2005,60,552,6,16,26,10,670
Grenada,GRD,2006,59,554,5,15,25,10,668
Grenada,GRD,2007,59,561,5,14,24,10,673
Grenada,GRD,2008,57,569,5,14,26,10,681
Grenada,GRD,2009,55,577,5,14,26,11,688
Grenada,GRD,2010,56,586,4,14,25,11,696
Grenada,GRD,2011,54,588,4,14,25,10,695
Grenada,GRD,2012,52,571,4,14,25,10,676
Grenada,GRD,2013,53,585,4,14,25,10,691
Grenada,GRD,2014,55,598,4,14,25,11,707
Grenada,GRD,2015,56,609,4,13,24,11,717
Grenada,GRD,2016,56,646,5,13,23,11,754
Grenada,GRD,2017,55,650,4,13,23,14,759
Grenada,GRD,2018,55,663,4,12,23,12,769
Grenada,GRD,2019,54,671,4,12,23,11,775
Guam,GUM,1990,32,432,4,21,50,9,548
Guam,GUM,1991,34,455,4,21,50,10,574
Guam,GUM,1992,34,469,4,22,52,9,590
Guam,GUM,1993,36,486,4,22,52,9,609
Guam,GUM,1994,36,492,4,22,52,8,614
Guam,GUM,1995,36,484,4,22,54,9,609
Guam,GUM,1996,36,484,4,22,55,9,610
Guam,GUM,1997,36,496,4,21,55,10,622
Guam,GUM,1998,36,512,4,20,54,8,634
Guam,GUM,1999,36,531,4,19,54,8,652
Guam,GUM,2000,37,555,6,19,55,8,680
Guam,GUM,2001,37,574,6,18,53,8,696
Guam,GUM,2002,37,594,6,19,54,7,717
Guam,GUM,2003,37,601,6,19,53,8,724
Guam,GUM,2004,36,598,6,20,53,8,721
Guam,GUM,2005,34,589,4,20,51,8,706
Guam,GUM,2006,37,609,4,21,52,7,730
Guam,GUM,2007,38,627,4,21,52,11,753
Guam,GUM,2008,39,654,4,21,52,12,782
Guam,GUM,2009,40,685,4,22,53,9,813
Guam,GUM,2010,40,701,4,22,54,10,831
Guam,GUM,2011,40,713,4,22,53,8,840
Guam,GUM,2012,43,749,6,22,54,8,882
Guam,GUM,2013,45,790,6,22,54,10,927
Guam,GUM,2014,46,823,6,22,55,8,960
Guam,GUM,2015,47,851,6,23,56,9,992
Guam,GUM,2016,50,878,6,23,57,9,1023
Guam,GUM,2017,51,902,6,22,57,9,1047
Guam,GUM,2018,52,923,6,22,56,9,1068
Guam,GUM,2019,53,962,6,22,56,9,1108
Guatemala,GTM,1990,24349,22205,10517,8875,1989,6113,74048
Guatemala,GTM,1991,24267,24073,10809,8862,2158,6198,76367
Guatemala,GTM,1992,23678,25499,10686,8990,2200,6354,77407
Guatemala,GTM,1993,23127,26769,10291,8493,2299,6060,77039
Guatemala,GTM,1994,22044,27153,9540,8627,2332,6446,76142
Guatemala,GTM,1995,20259,25416,8277,8558,2261,6524,71295
Guatemala,GTM,1996,19466,24997,7751,8206,2207,6362,68989
Guatemala,GTM,1997,19540,26455,7598,8113,2321,6752,70779
Guatemala,GTM,1998,19450,27924,7320,7946,2852,6666,72158
Guatemala,GTM,1999,18769,28217,6903,7682,2512,6281,70364
Guatemala,GTM,2000,18530,29509,6752,7365,2882,6270,71308
Guatemala,GTM,2001,18153,30590,7020,7533,2991,5886,72173
Guatemala,GTM,2002,17617,31320,6377,7384,3049,6198,71945
Guatemala,GTM,2003,17257,32764,6192,6669,3100,6802,72784
Guatemala,GTM,2004,17081,34310,6097,5867,3203,7342,73900
Guatemala,GTM,2005,16697,35561,6173,5671,3490,8874,76466
Guatemala,GTM,2006,16288,36962,6108,5075,3285,8907,76625
Guatemala,GTM,2007,15644,37817,5879,5056,3258,8712,76366
Guatemala,GTM,2008,15333,39064,5613,4776,3316,9209,77311
Guatemala,GTM,2009,14984,41508,5303,4594,3359,10074,79822
Guatemala,GTM,2010,14722,44003,4952,4035,3714,8916,80342
Guatemala,GTM,2011,14439,46044,4542,3877,3756,8127,80785
Guatemala,GTM,2012,14002,47663,4187,3996,3734,7618,81200
Guatemala,GTM,2013,13744,49427,3877,4087,3775,7537,82447
Guatemala,GTM,2014,13695,51330,3582,3857,3845,7381,83690
Guatemala,GTM,2015,13528,53327,3296,3692,3976,7365,85184
Guatemala,GTM,2016,13710,55182,3170,3573,4133,7306,87074
Guatemala,GTM,2017,13649,56359,3112,3400,4313,7431,88264
Guatemala,GTM,2018,13858,58011,3375,3380,4671,8134,91429
Guatemala,GTM,2019,14136,60143,3591,3339,4331,8566,94106
Guinea,GIN,1990,45102,22526,7733,14387,2640,680,93068
Guinea,GIN,1991,46097,23088,7671,14668,2692,713,94929
Guinea,GIN,1992,46860,23746,7639,14853,2750,743,96591
Guinea,GIN,1993,47468,24412,7500,15044,2798,773,97995
Guinea,GIN,1994,48504,25233,7403,15331,2875,813,100159
Guinea,GIN,1995,49356,25882,7303,15311,2921,839,101612
Guinea,GIN,1996,49069,26537,7128,15228,2956,895,101813
Guinea,GIN,1997,49299,27261,6932,15322,3000,897,102711
Guinea,GIN,1998,50194,28104,6808,15177,3078,967,104328
Guinea,GIN,1999,50515,28823,6666,14717,3122,1031,104874
Guinea,GIN,2000,50122,29293,6363,14235,3069,1808,104890
Guinea,GIN,2001,50254,29942,5957,13938,3088,1422,104601
Guinea,GIN,2002,50206,30710,5655,13862,3112,987,104532
Guinea,GIN,2003,50811,31192,5577,13787,3188,999,105554
Guinea,GIN,2004,52491,31945,5799,13754,3353,1050,108392
Guinea,GIN,2005,51888,32549,5670,13670,3394,1068,108239
Guinea,GIN,2006,51654,33335,5511,13627,3484,1119,108730
Guinea,GIN,2007,51744,33767,5302,13551,3537,1178,109079
Guinea,GIN,2008,51398,34085,4934,13414,3528,1147,108506
Guinea,GIN,2009,50009,34572,4543,13489,3528,1319,107460
Guinea,GIN,2010,50459,35145,4511,13503,3650,1211,108479
Guinea,GIN,2011,50072,35481,4343,13399,3684,1263,108242
Guinea,GIN,2012,49110,35832,4147,13297,3698,1258,107342
Guinea,GIN,2013,49539,36230,4214,13241,3836,1495,108555
Guinea,GIN,2014,49053,36720,4159,13277,3955,1352,108516
Guinea,GIN,2015,48482,37148,4150,13398,4042,1396,108616
Guinea,GIN,2016,47714,37219,4081,13450,4058,1418,107940
Guinea,GIN,2017,46315,37261,3898,13331,4034,1463,106302
Guinea,GIN,2018,44501,37408,3703,13291,4038,1465,104406
Guinea,GIN,2019,43276,37194,3426,13156,3964,1468,102484
Guinea-Bissau,GNB,1990,6750,3616,1071,2087,629,141,14294
Guinea-Bissau,GNB,1991,6744,3636,1038,2102,636,145,14301
Guinea-Bissau,GNB,1992,6755,3660,1004,2117,641,151,14328
Guinea-Bissau,GNB,1993,6777,3683,969,2130,648,153,14360
Guinea-Bissau,GNB,1994,6997,3708,932,2142,653,158,14590
Guinea-Bissau,GNB,1995,6824,3735,892,2156,661,163,14431
Guinea-Bissau,GNB,1996,7813,3763,842,2161,663,168,15410
Guinea-Bissau,GNB,1997,7662,3778,786,2140,664,173,15203
Guinea-Bissau,GNB,1998,7016,3814,742,2125,672,782,15151
Guinea-Bissau,GNB,1999,7470,3846,688,2110,670,380,15164
Guinea-Bissau,GNB,2000,7447,3900,663,2105,696,197,15008
Guinea-Bissau,GNB,2001,7446,3970,599,2107,709,207,15038
Guinea-Bissau,GNB,2002,7360,4065,543,2119,713,199,14999
Guinea-Bissau,GNB,2003,7215,4155,498,2137,725,206,14936
Guinea-Bissau,GNB,2004,6997,4284,458,2152,738,215,14844
Guinea-Bissau,GNB,2005,7058,4335,406,2157,720,214,14890
Guinea-Bissau,GNB,2006,6541,4422,379,2164,723,280,14509
Guinea-Bissau,GNB,2007,6918,4552,420,2179,783,228,15080
Guinea-Bissau,GNB,2008,6977,4628,393,2175,782,236,15191
Guinea-Bissau,GNB,2009,6594,4709,361,2160,775,237,14836
Guinea-Bissau,GNB,2010,6495,4777,339,2126,776,236,14749
Guinea-Bissau,GNB,2011,6273,4844,311,2074,762,237,14501
Guinea-Bissau,GNB,2012,5876,4909,273,2021,737,239,14055
Guinea-Bissau,GNB,2013,5898,5000,274,1977,755,238,14142
Guinea-Bissau,GNB,2014,5770,5094,265,1939,759,263,14090
Guinea-Bissau,GNB,2015,5470,5190,250,1901,755,245,13811
Guinea-Bissau,GNB,2016,5377,5290,250,1858,770,250,13795
Guinea-Bissau,GNB,2017,5225,5370,232,1802,763,250,13642
Guinea-Bissau,GNB,2018,5122,5407,206,1745,732,247,13459
Guinea-Bissau,GNB,2019,4943,5486,193,1701,725,250,13298
Guyana,GUY,1990,879,3986,287,651,438,153,6394
Guyana,GUY,1991,907,3786,258,625,419,144,6139
Guyana,GUY,1992,906,3671,232,595,394,123,5921
Guyana,GUY,1993,919,3841,225,575,404,138,6102
Guyana,GUY,1994,968,3768,207,552,396,145,6036
Guyana,GUY,1995,1080,3798,190,528,407,149,6152
Guyana,GUY,1996,1015,3862,188,499,443,171,6178
Guyana,GUY,1997,966,3782,170,476,458,174,6026
Guyana,GUY,1998,986,3723,158,456,477,184,5984
Guyana,GUY,1999,934,3594,151,429,489,167,5764
Guyana,GUY,2000,939,3706,152,395,455,196,5843
Guyana,GUY,2001,995,3771,145,385,484,183,5963
Guyana,GUY,2002,969,3890,143,384,487,205,6078
Guyana,GUY,2003,907,3935,137,373,488,225,6065
Guyana,GUY,2004,863,4001,134,367,493,204,6062
Guyana,GUY,2005,836,3999,127,352,521,214,6049
Guyana,GUY,2006,764,3976,123,329,490,215,5897
Guyana,GUY,2007,717,4067,121,317,489,191,5902
Guyana,GUY,2008,686,4143,118,311,476,243,5977
Guyana,GUY,2009,663,4143,111,297,476,181,5871
Guyana,GUY,2010,683,4279,109,280,493,194,6038
Guyana,GUY,2011,734,4324,101,267,500,199,6125
Guyana,GUY,2012,736,4438,97,261,512,196,6240
Guyana,GUY,2013,717,4472,95,251,500,215,6250
Guyana,GUY,2014,639,4616,101,255,512,217,6340
Guyana,GUY,2015,622,4631,97,238,500,209,6297
Guyana,GUY,2016,620,4691,95,231,498,209,6344
Guyana,GUY,2017,626,4774,94,227,502,210,6433
Guyana,GUY,2018,597,4867,94,224,501,214,6497
Guyana,GUY,2019,590,4929,92,216,485,214,6526
Haiti,HTI,1990,25915,33750,5229,5698,4102,2489,77183
Haiti,HTI,1991,27763,33546,4805,5620,3883,2805,78422
Haiti,HTI,1992,28205,33939,4511,5651,3910,2483,78699
Haiti,HTI,1993,29459,34243,4205,5711,3890,2512,80020
Haiti,HTI,1994,30711,34361,3903,5764,4880,2618,82237
Haiti,HTI,1995,31269,34529,3636,5834,3730,2558,81556
Haiti,HTI,1996,31693,34362,3413,5905,3689,2563,81625
Haiti,HTI,1997,31271,34764,3237,6015,3617,2682,81586
Haiti,HTI,1998,32447,34445,2955,5975,3595,2590,82007
Haiti,HTI,1999,31935,35093,2804,6058,3360,2708,81958
Haiti,HTI,2000,31595,35733,2647,6135,3407,2773,82290
Haiti,HTI,2001,30938,36671,2573,6271,3479,2891,82823
Haiti,HTI,2002,30776,37438,2509,6365,3471,2949,83508
Haiti,HTI,2003,30344,38503,2467,6511,3587,3051,84463
Haiti,HTI,2004,29749,39643,2445,6728,8981,3395,90941
Haiti,HTI,2005,29362,40664,2413,6909,3703,3257,86308
Haiti,HTI,2006,28589,41583,2371,7006,3650,3369,86568
Haiti,HTI,2007,27418,42620,2320,7091,3884,3396,86729
Haiti,HTI,2008,26717,43500,2275,7219,4440,3459,87610
Haiti,HTI,2009,26346,44363,2223,7297,3793,3513,87535
Haiti,HTI,2010,27591,44596,2174,7389,226421,3522,311693
Haiti,HTI,2011,30463,45415,2162,7472,3929,3665,93106
Haiti,HTI,2012,24157,46591,2152,7552,4138,3756,88346
Haiti,HTI,2013,23967,47742,2137,7646,4041,3870,89403
Haiti,HTI,2014,23041,48863,2109,7678,4211,3963,89865
Haiti,HTI,2015,22444,50102,2099,7757,4282,4051,90735
Haiti,HTI,2016,21874,51156,2051,7726,4934,4118,91859
Haiti,HTI,2017,20057,52243,1962,7567,4366,4170,90365
Haiti,HTI,2018,19382,53465,1908,7486,4355,4249,90845
Haiti,HTI,2019,19139,54599,1868,7417,4346,4283,91652
Honduras,HND,1990,5800,13112,743,3265,1206,1988,26114
Honduras,HND,1991,5702,13343,723,3271,1209,2091,26339
Honduras,HND,1992,5583,14225,705,3310,1219,2199,27241
Honduras,HND,1993,5461,14529,680,3293,1633,2286,27882
Honduras,HND,1994,5282,14914,653,3278,1372,2392,27891
Honduras,HND,1995,5179,16418,647,3321,1284,2507,29356
Honduras,HND,1996,4988,17557,626,3244,1263,2575,30253
Honduras,HND,1997,4781,17980,597,3191,1276,2681,30506
Honduras,HND,1998,4579,18403,571,3136,15906,2745,45340
Honduras,HND,1999,4330,18918,548,3077,1379,2810,31062
Honduras,HND,2000,4078,19457,519,2961,1369,2887,31271
Honduras,HND,2001,3911,20080,494,2901,1430,2947,31763
Honduras,HND,2002,3765,20768,467,2803,1456,2985,32244
Honduras,HND,2003,3645,21517,448,2751,1583,3035,32979
Honduras,HND,2004,3469,22290,428,2713,1609,3056,33565
Honduras,HND,2005,3358,23015,413,2687,1576,3121,34170
Honduras,HND,2006,3286,23818,403,2665,1534,3288,34994
Honduras,HND,2007,3230,24670,393,2644,1551,3486,35974
Honduras,HND,2008,3166,25813,382,2578,1601,3664,37204
Honduras,HND,2009,3132,27243,382,2538,1533,3813,38641
Honduras,HND,2010,3152,29016,386,2499,1662,3934,40649
Honduras,HND,2011,3181,31527,397,2432,1539,3812,42888
Honduras,HND,2012,3185,34347,402,2262,1831,8106,50133
Honduras,HND,2013,3186,35257,404,2236,1480,7899,50462
Honduras,HND,2014,3164,36053,404,2170,1517,7961,51269
Honduras,HND,2015,3134,36836,404,2112,1544,8613,52643
Honduras,HND,2016,3118,37740,405,2048,1584,3746,48641
Honduras,HND,2017,3103,38698,407,1976,1633,3767,49584
Honduras,HND,2018,3089,39680,411,1921,1654,3819,50574
Honduras,HND,2019,3083,40657,416,1872,1683,3875,51586
Hungary,HUN,1990,2254,129412,23,1128,7229,1651,141697
Hungary,HUN,1991,2252,129481,24,1145,7044,1788,141734
Hungary,HUN,1992,2281,134804,24,985,7144,1954,147192
Hungary,HUN,1993,2295,136642,25,861,6882,2059,148764
Hungary,HUN,1994,2184,134661,25,768,6539,2064,146241
Hungary,HUN,1995,2111,134207,25,682,6203,2037,145265
Hungary,HUN,1996,1982,128938,26,627,5701,1909,139183
Hungary,HUN,1997,1919,128658,27,573,5504,1873,138554
Hungary,HUN,1998,1854,130825,28,532,5538,1810,140587
Hungary,HUN,1999,1810,131375,29,478,5492,1705,140889
Hungary,HUN,2000,1647,125929,26,505,5074,1479,134660
Hungary,HUN,2001,1516,123236,27,450,4834,1427,131490
Hungary,HUN,2002,1473,124012,26,410,4802,1299,132022
Hungary,HUN,2003,1437,125478,27,387,4760,1271,133360
Hungary,HUN,2004,1406,124194,29,356,4618,1255,131858
Hungary,HUN,2005,1398,126527,35,343,4603,1247,134153
Hungary,HUN,2006,1347,124369,39,324,4422,1215,131716
Hungary,HUN,2007,1368,125744,44,316,4345,1193,133010
Hungary,HUN,2008,1325,122663,46,304,4090,1159,129587
Hungary,HUN,2009,1365,123500,49,271,3986,1118,130289
Hungary,HUN,2010,1397,122399,50,251,3787,1076,128960
Hungary,HUN,2011,1460,121665,51,235,3623,1046,128080
Hungary,HUN,2012,1523,120817,53,229,3510,1027,127159
Hungary,HUN,2013,1544,118314,52,229,3300,986,124425
Hungary,HUN,2014,1613,119153,51,217,3233,970,125237
Hungary,HUN,2015,1689,122033,52,220,3245,983,128222
Hungary,HUN,2016,1666,119563,50,188,3085,987,125539
Hungary,HUN,2017,1716,121806,50,170,3045,981,127768
Hungary,HUN,2018,1689,123886,50,157,3040,1002,129824
Hungary,HUN,2019,1636,122066,50,145,2965,1002,127864
Iceland,ISL,1990,111,1440,2,13,75,16,1657
Iceland,ISL,1991,112,1457,2,13,75,16,1675
Iceland,ISL,1992,115,1475,2,12,71,16,1691
Iceland,ISL,1993,115,1484,2,11,70,16,1698
Iceland,ISL,1994,115,1510,2,11,70,16,1724
Iceland,ISL,1995,117,1533,2,10,137,16,1815
Iceland,ISL,1996,114,1544,2,10,67,18,1755
Iceland,ISL,1997,109,1548,2,9,66,18,1752
Iceland,ISL,1998,102,1544,2,8,65,18,1739
Iceland,ISL,1999,101,1519,2,7,66,18,1713
Iceland,ISL,2000,97,1494,2,7,63,19,1682
Iceland,ISL,2001,92,1507,2,6,61,19,1687
Iceland,ISL,2002,90,1530,2,6,58,19,1705
Iceland,ISL,2003,88,1525,2,6,57,19,1697
Iceland,ISL,2004,89,1529,2,6,57,19,1702
Iceland,ISL,2005,92,1544,2,6,56,18,1718
Iceland,ISL,2006,91,1574,2,6,57,20,1750
Iceland,ISL,2007,92,1594,2,6,56,20,1770
Iceland,ISL,2008,93,1592,2,6,56,21,1770
Iceland,ISL,2009,93,1609,2,6,56,22,1788
Iceland,ISL,2010,94,1614,2,5,55,22,1792
Iceland,ISL,2011,94,1633,2,5,54,21,1809
Iceland,ISL,2012,94,1660,3,5,54,22,1838
Iceland,ISL,2013,96,1667,3,5,54,22,1847
Iceland,ISL,2014,94,1630,3,5,52,23,1807
Iceland,ISL,2015,97,1665,3,4,53,23,1845
Iceland,ISL,2016,100,1696,3,4,53,24,1880
Iceland,ISL,2017,106,1728,4,4,53,26,1921
Iceland,ISL,2018,108,1766,4,4,52,27,1961
Iceland,ISL,2019,110,1815,4,4,52,26,2011
India,IND,2007,2219903,4349857,114885,761686,480450,87434,8014215
India,IND,2008,2197474,4531335,107468,745737,488140,88938,8159092
India,IND,2009,2095141,4503905,98621,727409,484832,87140,7997048
India,IND,2012,1953206,4947496,83880,669078,508492,83532,8245684
India,IND,2013,1914667,5149194,76766,657367,501001,83678,8382673
India,IND,2015,1783541,5398635,60409,603948,462864,85169,8394566
India,IND,1990,2709657,2849160,470464,958934,397771,80284,7466270
India,IND,1991,2741474,2939610,441849,944491,408894,76535,7552853
India,IND,1992,2765453,3004475,412158,940376,412281,78362,7613105
India,IND,1993,2667462,3055780,386138,930020,424983,75620,7540003
India,IND,1994,2570530,3108245,362483,919128,419223,75713,7455322
India,IND,1995,2522662,3134630,340094,910762,419129,76042,7403319
India,IND,1996,2489729,3266484,314881,897896,422128,76750,7467868
India,IND,1997,2522906,3511180,292748,895795,445027,79592,7747248
India,IND,1998,2517291,3604584,266772,892780,461712,83904,7827043
India,IND,1999,2482268,3594448,240293,883334,477419,83702,7761464
India,IND,2000,2453004,3670718,219202,870300,470930,86624,7770778
India,IND,2001,2422726,3790828,199521,853661,487750,88948,7843434
India,IND,2002,2384619,3871244,178812,841127,459016,88582,7823400
India,IND,2003,2328474,3867261,158040,825836,445835,85635,7711081
India,IND,2004,2260405,3779355,141960,813726,465114,83872,7544432
India,IND,2005,2253486,3953697,128791,800921,466489,86712,7690096
India,IND,2006,2242074,4165319,123034,781108,475867,87186,7874588
India,IND,2010,2034015,4585116,91900,710223,493974,86622,8001850
India,IND,2011,2011692,4780027,86739,690332,505179,86807,8160776
India,IND,2014,1850250,5245412,67721,626122,471720,82029,8343254
India,IND,2016,1698248,5538800,51823,552361,457950,84804,8383986
India,IND,2017,1670937,5690818,46040,518446,460306,85384,8471931
India,IND,2018,1661287,5923142,43047,501268,480837,88458,8698039
India,IND,2019,1634033,6080656,40252,479847,489298,88661,8812747
Indonesia,IDN,2007,265549,1054034,34191,83586,60538,4771,1502669
Indonesia,IDN,2008,259302,1083431,35334,80663,58473,4733,1521936
Indonesia,IDN,2009,253489,1110938,36295,77695,58503,4760,1541680
Indonesia,IDN,2013,223917,1217579,39756,62373,53070,4650,1601345
Indonesia,IDN,2015,213672,1267344,41381,54939,51491,4615,1633442
Indonesia,IDN,2016,209582,1294223,40532,51335,51466,4611,1651749
Indonesia,IDN,1990,387195,649501,49918,120946,70020,4603,1282183
Indonesia,IDN,1991,372544,665692,47519,119926,69413,4860,1279954
Indonesia,IDN,1992,359261,684709,45563,118148,71559,4527,1283767
Indonesia,IDN,1993,349142,704537,43921,116387,68711,4503,1287201
Indonesia,IDN,1994,338223,723138,42315,114675,68613,4518,1291482
Indonesia,IDN,1995,327363,742412,40789,113138,67729,4638,1296069
Indonesia,IDN,1996,316253,762930,39133,110946,67499,4632,1301393
Indonesia,IDN,1997,309248,785818,38896,108621,67770,5168,1315521
Indonesia,IDN,1998,306865,809552,36387,107347,68186,4832,1333169
Indonesia,IDN,1999,303847,833383,35213,105398,68552,6651,1353044
Indonesia,IDN,2000,296511,859837,34667,102364,69055,5921,1368355
Indonesia,IDN,2001,292612,884836,34721,99950,69309,5866,1387294
Indonesia,IDN,2002,289134,912057,34839,97744,67972,5922,1407668
Indonesia,IDN,2003,284462,939685,34898,95554,66416,6021,1427036
Indonesia,IDN,2004,280671,968279,34926,92308,228839,6053,1611076
Indonesia,IDN,2005,274639,997916,34817,89289,62842,5199,1464702
Indonesia,IDN,2006,270947,1026320,34367,86404,67802,4860,1490700
Indonesia,IDN,2010,248683,1135104,37654,73782,56519,4659,1556401
Indonesia,IDN,2011,240360,1163478,38490,69551,53989,4699,1570567
Indonesia,IDN,2012,231476,1191181,39066,65602,53481,4627,1585433
Indonesia,IDN,2014,219316,1242204,40729,58485,52386,4628,1617748
Indonesia,IDN,2017,205822,1322178,40194,48866,51318,4590,1672968
Indonesia,IDN,2018,200659,1349952,39513,45683,56768,4671,1697246
Indonesia,IDN,2019,196970,1377414,38989,43389,51749,4632,1713143
Iran,IRN,2007,13820,228854,561,21785,38961,7482,311463
Iran,IRN,2008,13880,233093,563,21083,37905,7706,314230
Iran,IRN,2009,13987,238728,530,20496,36594,7862,318197
Iran,IRN,2010,14123,244751,523,20070,35762,7854,323083
Iran,IRN,2011,14188,250126,497,19653,34569,7658,326691
Iran,IRN,2012,14273,256375,476,19288,33828,7254,331494
Iran,IRN,2013,14426,265660,476,18632,32441,6985,338620
Iran,IRN,2014,14246,275467,464,17444,30875,6788,345284
Iran,IRN,2015,14194,287523,439,15322,29446,6642,353566
Iran,IRN,2016,13986,296177,427,11891,28588,6633,357702
Iran,IRN,1990,26886,146562,2665,51992,81065,5521,314691
Iran,IRN,1991,24929,148806,2208,47386,40866,5140,269335
Iran,IRN,1992,21916,151629,1892,43245,40029,4855,263566
Iran,IRN,1993,20324,154746,1656,41015,40579,4815,263135
Iran,IRN,1994,18860,158751,1491,39684,40021,4938,263745
Iran,IRN,1995,18040,163117,1376,38517,40204,4861,266115
Iran,IRN,1996,17170,167741,1228,37340,40472,4953,268904
Iran,IRN,1997,16140,172985,1141,36188,43617,5078,275149
Iran,IRN,1998,15596,178538,1051,34791,41455,5269,276700
Iran,IRN,1999,15282,184368,976,33010,41677,5468,280781
Iran,IRN,2000,14480,190495,899,30850,41912,5695,284331
Iran,IRN,2001,13844,196716,826,28730,42570,6011,288697
Iran,IRN,2002,13623,202883,733,26779,42340,6227,292585
Iran,IRN,2003,13574,208691,673,25321,68733,6670,323662
Iran,IRN,2004,13595,214486,622,24044,42103,7171,302021
Iran,IRN,2005,13623,219685,603,23307,41384,7228,305830
Iran,IRN,2006,13698,224949,584,22614,39696,7454,308995
Iran,IRN,2017,14037,304424,414,9927,29263,6377,364442
Iran,IRN,2018,14037,310637,405,8560,28227,7402,369268
Iran,IRN,2019,14219,319584,403,7561,28049,6264,376080
Iraq,IRQ,2007,9844,92237,539,15115,9074,41964,168773
Iraq,IRQ,2008,9437,95972,500,14505,9019,19559,148992
Iraq,IRQ,2009,8948,98263,456,13975,9192,13762,144596
Iraq,IRQ,2010,8446,100772,413,13423,9420,12089,144563
Iraq,IRQ,2011,7894,103325,373,12843,9581,12114,146130
Iraq,IRQ,2012,7247,105799,338,12214,9744,13727,149069
Iraq,IRQ,2013,6795,108431,309,11563,9862,24418,161378
Iraq,IRQ,2014,6503,111277,284,10918,9869,42960,181811
Iraq,IRQ,2015,6213,114459,262,10169,9963,35541,176607
Iraq,IRQ,2016,5971,117648,241,9450,9874,37603,180787
Iraq,IRQ,1990,12870,59884,965,17969,6273,3187,101148
Iraq,IRQ,1991,13376,61686,1040,18900,6814,2676,104492
Iraq,IRQ,1992,14081,64489,1122,19975,7302,2806,109775
Iraq,IRQ,1993,14751,66803,1183,20454,7655,2458,113304
Iraq,IRQ,1994,15108,68069,1189,20513,7963,3104,115946
Iraq,IRQ,1995,15535,70443,1209,20576,8250,3025,119038
Iraq,IRQ,1996,15764,72800,1211,20728,8620,2391,121514
Iraq,IRQ,1997,15680,74874,1156,20631,8835,2638,123814
Iraq,IRQ,1998,15373,76308,1065,20334,8964,2279,124323
Iraq,IRQ,1999,14882,77571,962,19865,9002,2343,124625
Iraq,IRQ,2000,14192,78872,872,19342,9053,2605,124936
Iraq,IRQ,2001,13128,80244,792,18826,9153,2611,124754
Iraq,IRQ,2002,12368,82031,724,18285,9231,2863,125502
Iraq,IRQ,2003,12162,84766,697,18116,9469,17707,142917
Iraq,IRQ,2004,11546,86513,642,17500,9421,19426,145048
Iraq,IRQ,2005,11009,87893,613,16616,9277,26590,151998
Iraq,IRQ,2006,10325,89019,577,15775,9118,43470,168284
Iraq,IRQ,2017,5735,121409,226,8735,9895,33821,179821
Iraq,IRQ,2018,5512,127966,209,8095,9643,8051,159476
Iraq,IRQ,2019,5372,135278,195,7622,9470,7377,165314
Ireland,IRL,1990,1986,26305,24,162,1008,116,29601
Ireland,IRL,1991,2007,26209,22,149,1008,124,29519
Ireland,IRL,1992,2026,26298,21,130,992,136,29603
Ireland,IRL,1993,2101,26530,21,122,994,146,29914
Ireland,IRL,1994,2141,26261,20,119,1001,166,29708
Ireland,IRL,1995,2280,26590,20,127,1039,189,30245
Ireland,IRL,1996,2320,26390,20,131,1066,212,30139
Ireland,IRL,1997,2352,26271,21,134,1084,235,30097
Ireland,IRL,1998,2389,26168,22,132,1095,260,30066
Ireland,IRL,1999,2482,26292,24,136,1092,278,30304
Ireland,IRL,2000,2412,25783,24,134,1090,288,29731
Ireland,IRL,2001,2273,24961,23,140,1060,293,28750
Ireland,IRL,2002,2182,24557,23,131,1022,295,28210
Ireland,IRL,2003,2085,24152,23,124,961,285,27630
Ireland,IRL,2004,1967,23952,23,115,955,286,27298
Ireland,IRL,2005,1868,23685,21,108,950,303,26935
Ireland,IRL,2006,1795,23828,20,106,938,337,27024
Ireland,IRL,2007,1675,23742,20,105,923,354,26819
Ireland,IRL,2008,1612,23828,20,116,926,364,26866
Ireland,IRL,2009,1562,24029,19,113,943,380,27046
Ireland,IRL,2010,1471,23581,17,117,868,360,26414
Ireland,IRL,2011,1478,24430,16,110,869,352,27255
Ireland,IRL,2012,1485,24892,15,107,822,343,27664
Ireland,IRL,2013,1488,25215,14,106,776,330,27929
Ireland,IRL,2014,1509,25372,14,100,749,322,28066
Ireland,IRL,2015,1578,25885,14,97,708,316,28598
Ireland,IRL,2016,1627,26150,14,87,685,322,28885
Ireland,IRL,2017,1683,26700,16,85,680,324,29488
Ireland,IRL,2018,1748,27395,16,80,687,336,30262
Ireland,IRL,2019,1812,28103,16,76,680,344,31031
Israel,ISR,1990,904,24923,18,520,1010,345,27720
Israel,ISR,1991,913,26457,20,505,1074,308,29277
Israel,ISR,1992,926,27873,20,507,1135,340,30801
Israel,ISR,1993,890,28234,20,463,1162,331,31100
Israel,ISR,1994,837,29001,21,441,1249,415,31964
Israel,ISR,1995,903,30025,24,432,1331,326,33041
Israel,ISR,1996,939,30282,28,424,1397,459,33529
Israel,ISR,1997,1014,30681,32,428,1472,301,33928
Israel,ISR,1998,1053,31330,39,420,1430,282,34554
Israel,ISR,1999,1086,31508,47,416,1414,330,34801
Israel,ISR,2000,1124,31682,50,406,1450,498,35210
Israel,ISR,2001,1120,31575,51,389,1453,880,35468
Israel,ISR,2002,1166,31956,53,393,1440,1625,36633
Israel,ISR,2003,1220,32127,57,374,1396,1028,36202
Israel,ISR,2004,1254,32013,54,340,1360,997,36018
Israel,ISR,2005,1335,32439,54,321,1353,668,36170
Israel,ISR,2006,1386,32496,56,315,1297,1071,36621
Israel,ISR,2007,1509,32983,64,301,1296,664,36817
Israel,ISR,2008,1556,32687,73,301,1281,1080,36978
Israel,ISR,2009,1578,32611,77,300,1258,1034,36858
Israel,ISR,2010,1639,33064,82,296,1269,393,36743
Israel,ISR,2011,1752,34004,84,283,1223,415,37761
Israel,ISR,2012,1839,34429,84,282,1196,386,38216
Israel,ISR,2013,1903,34912,84,270,1192,310,38671
Israel,ISR,2014,1971,35379,86,268,1176,2031,40911
Israel,ISR,2015,2088,36508,87,263,1199,324,40469
Israel,ISR,2016,2112,36936,89,268,1207,324,40936
Israel,ISR,2017,2124,38005,91,258,1217,341,42036
Israel,ISR,2018,2180,39508,93,247,1257,404,43689
Israel,ISR,2019,2219,40664,95,235,1252,342,44807
Italy,ITA,1990,11864,493897,126,2571,17416,3276,529150
Italy,ITA,1991,12382,501076,136,2509,17614,3419,537136
Italy,ITA,1992,12759,499459,148,2404,17269,3250,535289
Italy,ITA,1993,13340,501391,172,2158,16697,2979,536737
Italy,ITA,1994,14006,504718,202,1954,16482,2892,540254
Italy,ITA,1995,14415,506028,250,1833,16215,2861,541602
Italy,ITA,1996,14216,508940,289,1792,16044,2806,544087
Italy,ITA,1997,12736,512249,328,1678,16010,2666,545667
Italy,ITA,1998,12059,519540,373,1533,16168,2603,552276
Italy,ITA,1999,11929,517187,409,1468,15484,2462,548939
Italy,ITA,2000,11712,513658,444,1359,15083,2292,544548
Italy,ITA,2001,11431,514414,492,1336,14658,2156,544487
Italy,ITA,2002,11401,518884,556,1267,14223,2052,548383
Italy,ITA,2003,11658,526169,653,1220,13715,2065,555480
Italy,ITA,2004,10899,512537,667,1205,13047,1967,540322
Italy,ITA,2005,10990,515042,726,1153,12662,1876,542449
Italy,ITA,2006,10922,518076,794,1148,12422,1852,545214
Italy,ITA,2007,11182,524487,870,1130,12182,1846,551697
Italy,ITA,2008,11405,530960,937,1132,11973,1772,558179
Italy,ITA,2009,11608,535157,983,1121,12044,1735,562648
Italy,ITA,2010,11790,533963,1034,1053,11386,1676,560902
Italy,ITA,2011,12343,542092,1111,991,11264,1638,569439
Italy,ITA,2012,12917,548312,1174,946,11107,1638,576094
Italy,ITA,2013,13014,545455,1190,894,10757,1597,572907
Italy,ITA,2014,13273,547296,1224,839,10481,1546,574659
Italy,ITA,2015,14144,565542,1301,815,10553,1586,593941
Italy,ITA,2016,14223,562021,1314,755,10558,1559,590430
Italy,ITA,2017,14246,570283,1307,703,10258,1591,598388
Italy,ITA,2018,14518,584909,1326,661,10377,1636,613427
Italy,ITA,2019,14723,595779,1338,623,10442,1666,624571
Jamaica,JAM,2007,965,12735,134,574,273,786,15467
Jamaica,JAM,2008,994,14053,136,576,345,755,16859
Jamaica,JAM,2009,943,14775,129,552,359,1036,17794
Jamaica,JAM,1990,990,9752,380,829,189,271,12411
Jamaica,JAM,1991,945,9155,344,842,203,275,11764
Jamaica,JAM,1992,962,9606,325,866,195,318,12272
Jamaica,JAM,1993,987,10223,306,871,209,315,12911
Jamaica,JAM,1994,1002,10541,283,875,214,358,13273
Jamaica,JAM,1995,1013,10681,260,852,223,429,13458
Jamaica,JAM,1996,1027,10813,238,837,234,525,13674
Jamaica,JAM,1997,1064,11165,223,815,243,620,14130
Jamaica,JAM,1998,1108,11422,211,789,251,637,14418
Jamaica,JAM,1999,1196,11983,210,767,267,642,15065
Jamaica,JAM,2000,1342,12279,206,745,271,366,15209
Jamaica,JAM,2001,1383,12492,207,724,262,396,15464
Jamaica,JAM,2002,1281,12103,193,693,263,347,14880
Jamaica,JAM,2003,1159,11858,179,652,238,340,14426
Jamaica,JAM,2004,1144,11695,156,627,243,376,14241
Jamaica,JAM,2005,813,11264,139,603,239,744,13802
Jamaica,JAM,2006,930,11437,132,580,235,594,13908
Jamaica,JAM,2010,1071,13418,114,551,304,540,15998
Jamaica,JAM,2011,948,14308,116,543,321,680,16916
Jamaica,JAM,2012,934,13517,102,529,278,341,15701
Jamaica,JAM,2013,943,13751,104,522,263,309,15892
Jamaica,JAM,2014,987,15029,113,533,281,287,17230
Jamaica,JAM,2015,981,15409,115,494,285,386,17670
Jamaica,JAM,2016,969,15516,115,472,290,403,17765
Jamaica,JAM,2017,965,15736,117,454,292,412,17976
Jamaica,JAM,2018,964,16010,119,438,295,419,18245
Jamaica,JAM,2019,970,16425,123,428,304,439,18689
Japan,JPN,2007,100531,942943,2437,938,50602,4138,1101589
Japan,JPN,2008,102551,964351,2501,906,49922,4164,1124395
Japan,JPN,2009,103788,981317,2552,858,49359,4154,1142028
Japan,JPN,2010,107393,1012042,2653,817,48827,4366,1176098
Japan,JPN,2012,111912,1061174,2822,752,47049,4322,1228031
Japan,JPN,2013,112789,1075090,2862,703,45851,4288,1241583
Japan,JPN,2014,112801,1085323,2889,663,44511,4240,1250427
Japan,JPN,2015,114138,1099029,2941,631,42815,4452,1264006
Japan,JPN,2016,115921,1119760,3019,600,41946,4270,1285516
Japan,JPN,1990,70110,685911,899,2246,45159,3232,807557
Japan,JPN,1991,73114,700026,953,2119,45369,3220,824801
Japan,JPN,1992,76457,718158,1036,2052,45810,3296,846809
Japan,JPN,1993,79260,732232,1141,1976,46530,3367,864506
Japan,JPN,1994,80490,737744,1277,1899,46126,3474,871010
Japan,JPN,1995,82247,757898,1498,1793,52622,3449,899507
Japan,JPN,1996,80716,757935,1582,1657,47353,3428,892671
Japan,JPN,1997,81795,766221,1687,1576,48402,3505,903186
Japan,JPN,1998,84107,789573,1836,1530,51440,3671,932157
Japan,JPN,1999,87206,809560,1961,1424,53040,3766,956957
Japan,JPN,2000,85969,811500,1992,1345,52540,3810,957156
Japan,JPN,2001,85491,818492,2030,1252,52370,3842,963477
Japan,JPN,2002,86763,832245,2082,1206,52066,3898,978260
Japan,JPN,2003,89756,855268,2164,1146,52620,3951,1004905
Japan,JPN,2004,92039,875314,2229,1061,52403,4195,1027241
Japan,JPN,2005,96944,907100,2358,1020,52313,4048,1063783
Japan,JPN,2006,98509,922016,2384,989,51357,4071,1079326
Japan,JPN,2011,110221,1044433,2764,781,66682,4406,1229287
Japan,JPN,2017,116273,1135201,3084,561,40992,4132,1300243
Japan,JPN,2018,122320,1164915,3149,537,41376,4225,1336522
Japan,JPN,2019,126996,1193532,3227,509,41185,4324,1369773
Jordan,JOR,2007,902,13022,24,1599,1185,310,17042
Jordan,JOR,2008,896,12935,24,1594,1206,320,16975
Jordan,JOR,2009,897,13328,23,1579,1194,315,17336
Jordan,JOR,2014,1033,17185,23,1592,1415,360,21608
Jordan,JOR,2015,1076,18343,24,1618,1482,381,22924
Jordan,JOR,1990,1036,8368,30,2155,1035,173,12797
Jordan,JOR,1991,1029,8591,28,2142,1068,179,13037
Jordan,JOR,1992,1009,8755,28,2099,1072,198,13161
Jordan,JOR,1993,1007,9292,28,2065,1120,190,13702
Jordan,JOR,1994,991,9601,27,2002,1142,199,13962
Jordan,JOR,1995,982,9986,30,1950,1166,207,14321
Jordan,JOR,1996,973,10348,27,1924,1181,214,14667
Jordan,JOR,1997,951,10528,26,1888,1179,220,14792
Jordan,JOR,1998,956,10754,28,1855,1195,234,15022
Jordan,JOR,1999,931,10964,30,1808,1186,246,15165
Jordan,JOR,2000,917,11010,26,1759,1216,265,15193
Jordan,JOR,2001,901,11365,26,1703,1196,280,15471
Jordan,JOR,2002,884,11631,26,1645,1184,288,15658
Jordan,JOR,2003,869,11603,25,1595,1204,300,15596
Jordan,JOR,2004,874,12152,26,1580,1213,315,16160
Jordan,JOR,2005,889,12858,27,1600,1217,441,17032
Jordan,JOR,2006,908,13310,26,1602,1199,315,17360
Jordan,JOR,2010,905,13956,22,1544,1189,316,17932
Jordan,JOR,2011,933,14702,22,1527,1224,318,18726
Jordan,JOR,2012,956,15414,22,1543,1294,334,19563
Jordan,JOR,2013,981,16099,22,1547,1348,351,20348
Jordan,JOR,2016,1137,19800,28,1689,1583,468,24705
Jordan,JOR,2017,1193,21318,32,1727,1676,427,26373
Jordan,JOR,2018,1228,23097,32,1664,1804,1277,29102
Jordan,JOR,2019,1272,24868,34,1654,1847,453,30128
Kazakhstan,KAZ,1990,10619,96835,183,3435,10255,4898,126225
Kazakhstan,KAZ,1991,10489,101564,171,3315,10355,5121,131015
Kazakhstan,KAZ,1992,10654,107579,168,3265,10501,5863,138030
Kazakhstan,KAZ,1993,11122,117359,165,3133,10500,6402,148681
Kazakhstan,KAZ,1994,11666,124322,167,3011,10401,6874,156441
Kazakhstan,KAZ,1995,12446,129265,173,2867,10760,7330,162841
Kazakhstan,KAZ,1996,12715,128734,180,2727,10518,7458,162332
Kazakhstan,KAZ,1997,12488,125464,183,2626,10098,7577,158436
Kazakhstan,KAZ,1998,11885,121882,171,2521,9714,7608,153781
Kazakhstan,KAZ,1999,11199,119512,154,2459,9580,7742,150646
Kazakhstan,KAZ,2000,10688,120222,145,2459,10229,8436,152179
Kazakhstan,KAZ,2001,10140,121309,145,2520,10649,8644,153407
Kazakhstan,KAZ,2002,9740,123842,140,2606,10936,8588,155852
Kazakhstan,KAZ,2003,9442,127465,154,2707,11456,8858,160082
Kazakhstan,KAZ,2004,9180,128039,165,2818,12183,9300,161685
Kazakhstan,KAZ,2005,9071,130366,174,2938,12851,9219,164619
Kazakhstan,KAZ,2006,8688,131457,180,3030,13250,8991,165596
Kazakhstan,KAZ,2007,8157,131118,188,3099,13113,8531,164206
Kazakhstan,KAZ,2008,7378,127631,187,3184,12117,7832,158329
Kazakhstan,KAZ,2009,6724,124314,191,3189,11273,7145,152836
Kazakhstan,KAZ,2010,6413,125630,203,3096,11122,6970,153434
Kazakhstan,KAZ,2011,6143,126115,214,2897,10861,6723,152953
Kazakhstan,KAZ,2012,5952,125822,220,2721,10645,6429,151789
Kazakhstan,KAZ,2013,5806,122162,210,2517,10237,5844,146776
Kazakhstan,KAZ,2014,5677,119670,207,2320,9719,5424,143017
Kazakhstan,KAZ,2015,5668,118593,207,2146,9260,5287,141161
Kazakhstan,KAZ,2016,5514,118722,213,1974,8790,5200,140413
Kazakhstan,KAZ,2017,5534,118167,233,1827,8545,4852,139158
Kazakhstan,KAZ,2018,5374,119368,213,1749,8363,5163,140230
Kazakhstan,KAZ,2019,5258,119358,205,1647,8421,5409,140298
Kenya,KEN,2007,185519,84872,10650,24779,7668,5363,318851
Kenya,KEN,2008,175314,87683,10274,24699,7843,7274,313087
Kenya,KEN,2009,166777,90687,10166,24744,8043,5585,306002
Kenya,KEN,1990,90596,44823,14856,20099,4196,2254,176824
Kenya,KEN,1991,102476,46335,14583,20213,4242,2334,190183
Kenya,KEN,1992,116638,47921,14297,20377,4349,2916,206498
Kenya,KEN,1993,131835,49272,13914,20528,4425,2773,222747
Kenya,KEN,1994,147392,50637,13488,20709,4517,2643,239386
Kenya,KEN,1995,162560,52025,13074,20942,4611,2726,255938
Kenya,KEN,1996,175876,53529,12672,21229,4720,2919,270945
Kenya,KEN,1997,188401,55414,12281,21679,4980,3416,286171
Kenya,KEN,1998,198804,57587,11840,22091,5161,3660,299143
Kenya,KEN,1999,206057,59455,11388,22473,5256,3656,308285
Kenya,KEN,2000,209317,62385,11477,22963,5564,4406,316112
Kenya,KEN,2001,213184,64848,10955,23412,5877,4124,322400
Kenya,KEN,2002,214814,68526,10754,23997,6292,4077,328460
Kenya,KEN,2003,218886,72205,10941,24204,6686,4094,337016
Kenya,KEN,2004,215184,75673,11042,24444,6989,4322,337654
Kenya,KEN,2005,207002,78931,10900,24588,7231,4884,333536
Kenya,KEN,2006,196460,82009,10825,24768,7638,5062,326762
Kenya,KEN,2010,158669,93874,10469,24845,8424,5503,301784
Kenya,KEN,2011,150402,96889,10744,24952,8486,5644,297117
Kenya,KEN,2012,144090,99273,10512,24763,8616,6042,293296
Kenya,KEN,2013,142014,101328,10410,24539,8705,6417,293413
Kenya,KEN,2014,139247,103546,10217,24240,8619,6144,292013
Kenya,KEN,2015,133645,105849,9900,23835,8680,6388,288297
Kenya,KEN,2016,128112,108568,9681,23442,8750,6042,284595
Kenya,KEN,2017,124810,111999,10026,22987,8830,6362,285014
Kenya,KEN,2018,122475,115830,9441,22404,9139,6268,285557
Kenya,KEN,2019,121905,119724,9076,22084,9193,6195,288177
Kiribati,KIR,1990,214,514,50,78,45,11,912
Kiribati,KIR,1991,214,526,50,77,45,11,923
Kiribati,KIR,1992,214,536,50,76,46,9,931
Kiribati,KIR,1993,210,544,50,75,46,7,932
Kiribati,KIR,1994,204,545,48,73,45,9,924
Kiribati,KIR,1995,201,547,47,72,45,13,925
Kiribati,KIR,1996,194,556,46,71,45,6,918
Kiribati,KIR,1997,192,570,44,70,46,5,927
Kiribati,KIR,1998,189,581,43,70,46,5,934
Kiribati,KIR,1999,189,595,44,70,47,5,950
Kiribati,KIR,2000,185,605,44,69,47,5,955
Kiribati,KIR,2001,183,611,42,69,49,5,959
Kiribati,KIR,2002,182,618,40,68,49,6,963
Kiribati,KIR,2003,178,625,39,68,50,6,966
Kiribati,KIR,2004,176,634,37,67,51,8,973
Kiribati,KIR,2005,174,643,36,67,52,8,980
Kiribati,KIR,2006,175,653,35,66,53,8,990
Kiribati,KIR,2007,178,665,36,66,54,8,1007
Kiribati,KIR,2008,175,681,35,65,55,8,1019
Kiribati,KIR,2009,175,691,34,65,56,9,1030
Kiribati,KIR,2010,177,702,34,64,57,9,1043
Kiribati,KIR,2011,177,713,33,63,57,10,1053
Kiribati,KIR,2012,176,724,31,62,57,10,1060
Kiribati,KIR,2013,175,737,30,61,57,10,1070
Kiribati,KIR,2014,177,745,29,60,58,10,1079
Kiribati,KIR,2015,173,756,28,58,58,10,1083
Kiribati,KIR,2016,170,771,27,57,58,10,1093
Kiribati,KIR,2017,167,787,27,55,58,10,1104
Kiribati,KIR,2018,163,802,26,54,57,10,1112
Kiribati,KIR,2019,162,815,26,53,58,10,1124
Kuwait,KWT,2007,377,4916,1,192,630,91,6207
Kuwait,KWT,2008,444,5602,1,216,705,79,7047
Kuwait,KWT,2009,474,5486,1,248,719,77,7005
Kuwait,KWT,2013,583,5417,1,217,652,68,6938
Kuwait,KWT,1990,256,2596,3,263,500,1223,4841
Kuwait,KWT,1991,202,2352,2,173,447,2530,5706
Kuwait,KWT,1992,199,2217,1,198,420,81,3116
Kuwait,KWT,1993,191,2353,1,167,417,89,3218
Kuwait,KWT,1994,210,2573,1,202,444,86,3516
Kuwait,KWT,1995,218,2811,0,169,460,68,3726
Kuwait,KWT,1996,207,2874,0,162,434,81,3758
Kuwait,KWT,1997,227,3263,0,185,493,72,4240
Kuwait,KWT,1998,217,3265,0,158,464,73,4177
Kuwait,KWT,1999,238,3627,1,160,514,81,4621
Kuwait,KWT,2000,239,3715,0,168,526,69,4717
Kuwait,KWT,2001,228,3581,0,147,474,73,4503
Kuwait,KWT,2002,260,3922,0,174,520,67,4943
Kuwait,KWT,2003,273,3997,0,175,525,90,5060
Kuwait,KWT,2004,289,4227,1,179,548,119,5363
Kuwait,KWT,2005,320,4498,1,177,596,90,5682
Kuwait,KWT,2006,352,4764,1,184,625,94,6020
Kuwait,KWT,2010,469,5103,1,226,612,68,6479
Kuwait,KWT,2011,492,5054,1,213,602,63,6425
Kuwait,KWT,2012,545,5314,1,207,644,66,6777
Kuwait,KWT,2014,621,5531,1,236,665,76,7130
Kuwait,KWT,2015,621,5869,1,252,688,134,7565
Kuwait,KWT,2016,648,6332,1,228,707,86,8002
Kuwait,KWT,2017,668,6766,1,221,728,89,8473
Kuwait,KWT,2018,690,7223,1,213,748,93,8968
Kuwait,KWT,2019,716,7714,1,209,775,97,9512
Kyrgyzstan,KGZ,1990,4709,23297,52,2236,2472,1151,33917
Kyrgyzstan,KGZ,1991,4497,24104,52,2174,2497,1116,34440
Kyrgyzstan,KGZ,1992,4320,24979,54,2067,2454,1248,35122
Kyrgyzstan,KGZ,1993,4244,26925,54,1965,2424,1410,37022
Kyrgyzstan,KGZ,1994,4196,28866,55,1894,2640,1566,39217
Kyrgyzstan,KGZ,1995,4111,29101,54,1825,2446,1580,39117
Kyrgyzstan,KGZ,1996,4005,28131,51,1697,2309,1501,37694
Kyrgyzstan,KGZ,1997,3995,27823,51,1613,2198,1381,37061
Kyrgyzstan,KGZ,1998,3950,27857,51,1485,2120,1326,36789
Kyrgyzstan,KGZ,1999,3826,27647,46,1438,2034,1293,36284
Kyrgyzstan,KGZ,2000,3710,29938,40,1468,2010,1409,38575
Kyrgyzstan,KGZ,2001,3563,30705,37,1529,2019,1193,39046
Kyrgyzstan,KGZ,2002,3352,31157,39,1628,2062,1186,39424
Kyrgyzstan,KGZ,2003,3168,31701,37,1725,2124,1194,39949
Kyrgyzstan,KGZ,2004,2939,31181,34,1844,2095,1201,39294
Kyrgyzstan,KGZ,2005,2866,31594,33,1963,2116,1241,39813
Kyrgyzstan,KGZ,2006,2819,32476,32,2068,2211,1256,40862
Kyrgyzstan,KGZ,2007,2649,32224,29,2139,2233,1209,40483
Kyrgyzstan,KGZ,2008,2365,31664,26,2094,2284,1163,39596
Kyrgyzstan,KGZ,2009,2197,30358,24,2080,2154,1108,37921
Kyrgyzstan,KGZ,2010,2073,29816,22,2017,2160,1531,37619
Kyrgyzstan,KGZ,2011,1987,29541,22,1925,2148,1093,36716
Kyrgyzstan,KGZ,2012,1956,29165,20,1895,2154,997,36187
Kyrgyzstan,KGZ,2013,1932,28708,18,1917,2133,945,35653
Kyrgyzstan,KGZ,2014,1866,28799,15,1922,2105,909,35616
Kyrgyzstan,KGZ,2015,1752,29429,16,1818,2063,900,35978
Kyrgyzstan,KGZ,2016,1603,28622,16,1629,1922,844,34636
Kyrgyzstan,KGZ,2017,1527,28924,15,1479,1932,841,34718
Kyrgyzstan,KGZ,2018,1516,28924,16,1426,1920,907,34709
Kyrgyzstan,KGZ,2019,1497,29419,16,1364,1932,944,35172
Laos,LAO,1990,20959,18290,2663,7482,2607,1045,53046
Laos,LAO,1991,20781,18655,2367,7501,2610,810,52724
Laos,LAO,1992,20551,19056,2133,7532,2652,828,52752
Laos,LAO,1993,20585,19456,1953,7546,2633,846,53019
Laos,LAO,1994,20550,19833,1813,7527,2627,862,53212
Laos,LAO,1995,19799,20226,1719,7500,2658,877,52779
Laos,LAO,1996,19482,20493,1641,7450,2637,890,52593
Laos,LAO,1997,18919,20783,1571,7379,2601,908,52161
Laos,LAO,1998,18308,21090,1506,7282,2606,932,51724
Laos,LAO,1999,17686,21369,1438,7154,2587,944,51178
Laos,LAO,2000,17291,21580,1362,6968,2544,938,50683
Laos,LAO,2001,16417,21945,1287,6788,2541,935,49913
Laos,LAO,2002,15747,22025,1209,6564,2522,932,48999
Laos,LAO,2003,15001,22215,1112,6304,2488,939,48059
Laos,LAO,2004,14218,22389,1014,6041,2445,921,47028
Laos,LAO,2005,13519,22685,933,5819,2414,922,46292
Laos,LAO,2006,12876,22944,856,5605,2373,991,45645
Laos,LAO,2007,12137,23151,780,5380,2322,912,44682
Laos,LAO,2008,11830,23492,750,5191,2356,915,44534
Laos,LAO,2009,11170,23724,694,4972,2346,916,43822
Laos,LAO,2010,10592,23929,637,4736,2259,909,43062
Laos,LAO,2011,9997,24116,585,4527,2240,890,42355
Laos,LAO,2012,9696,24403,544,4321,2143,896,42003
Laos,LAO,2013,9128,24846,509,4159,2150,882,41674
Laos,LAO,2014,8733,25354,476,3986,2122,711,41382
Laos,LAO,2015,8355,25968,451,3838,2100,715,41427
Laos,LAO,2016,7983,26561,427,3716,2091,718,41496
Laos,LAO,2017,7665,27232,402,3587,2056,704,41646
Laos,LAO,2018,7412,28004,388,3468,2173,696,42141
Laos,LAO,2019,7198,28843,377,3358,2013,689,42478
Latvia,LVA,1990,651,27821,37,216,2444,948,32117
Latvia,LVA,1991,671,27908,35,222,2567,1053,32456
Latvia,LVA,1992,745,28604,34,213,2705,1227,33528
Latvia,LVA,1993,874,31578,32,187,3103,1543,37317
Latvia,LVA,1994,1003,33739,28,167,3392,1700,40029
Latvia,LVA,1995,975,31722,23,152,3056,1551,37479
Latvia,LVA,1996,819,27894,14,134,2439,1282,32582
Latvia,LVA,1997,785,27120,11,122,2239,1233,31510
Latvia,LVA,1998,810,28171,8,118,2317,1238,32662
Latvia,LVA,1999,777,27017,7,106,2148,1190,31245
Latvia,LVA,2000,762,26420,7,95,2015,1154,30453
Latvia,LVA,2001,777,27666,9,89,2033,1191,31765
Latvia,LVA,2002,764,27410,9,83,1911,1103,31280
Latvia,LVA,2003,754,27416,9,81,1737,1046,31043
Latvia,LVA,2004,720,27286,9,78,1638,1004,30735
Latvia,LVA,2005,753,28177,9,75,1647,1022,31683
Latvia,LVA,2006,779,29432,10,78,1632,1124,33055
Latvia,LVA,2007,733,29006,10,82,1534,942,32307
Latvia,LVA,2008,680,27408,10,71,1344,855,30368
Latvia,LVA,2009,623,26555,10,64,1205,775,29232
Latvia,LVA,2010,626,26348,10,55,1155,738,28932
Latvia,LVA,2011,607,25925,9,53,1045,692,28331
Latvia,LVA,2012,608,25723,9,52,1002,692,28086
Latvia,LVA,2013,630,26201,8,46,987,659,28531
Latvia,LVA,2014,603,25603,7,43,955,649,27860
Latvia,LVA,2015,594,25211,7,44,909,614,27379
Latvia,LVA,2016,558,24683,7,35,842,600,26725
Latvia,LVA,2017,549,24693,7,34,834,597,26714
Latvia,LVA,2018,542,24875,6,32,826,594,26875
Latvia,LVA,2019,534,24965,6,29,816,594,26944
Lebanon,LBN,1990,1122,14881,28,1691,728,2333,20783
Lebanon,LBN,1991,1102,15028,27,1607,673,482,18919
Lebanon,LBN,1992,1088,15301,26,1517,694,525,19151
Lebanon,LBN,1993,1102,15575,25,1430,669,481,19282
Lebanon,LBN,1994,1061,15691,25,1338,660,511,19286
Lebanon,LBN,1995,1049,15861,24,1241,652,469,19296
Lebanon,LBN,1996,1035,16125,23,1147,647,574,19551
Lebanon,LBN,1997,1018,16486,23,1064,644,433,19668
Lebanon,LBN,1998,1010,16856,23,1002,639,398,19928
Lebanon,LBN,1999,1003,17220,22,947,630,385,20207
Lebanon,LBN,2000,1003,17675,22,893,617,348,20558
Lebanon,LBN,2001,1010,18248,22,843,611,282,21016
Lebanon,LBN,2002,1017,18868,22,801,604,273,21585
Lebanon,LBN,2003,1023,19580,22,767,603,273,22268
Lebanon,LBN,2004,1043,20360,22,739,607,270,23041
Lebanon,LBN,2005,1064,21181,24,719,615,296,23899
Lebanon,LBN,2006,1087,22035,24,698,619,1029,25492
Lebanon,LBN,2007,1110,22911,24,678,628,320,25671
Lebanon,LBN,2008,1134,23735,24,652,637,463,26645
Lebanon,LBN,2009,1156,24478,24,625,646,301,27230
Lebanon,LBN,2010,1172,25139,25,606,654,291,27887
Lebanon,LBN,2011,1200,25998,25,604,686,321,28834
Lebanon,LBN,2012,1222,26760,26,617,734,403,29762
Lebanon,LBN,2013,1239,27428,27,618,771,548,30631
Lebanon,LBN,2014,1248,27992,27,593,780,714,31354
Lebanon,LBN,2015,1242,28464,27,558,776,691,31758
Lebanon,LBN,2016,1242,28896,27,516,770,677,32128
Lebanon,LBN,2017,1245,29300,27,478,767,754,32571
Lebanon,LBN,2018,1246,29694,27,446,780,1230,33423
Lebanon,LBN,2019,1250,30082,27,417,765,410,32951
Lesotho,LSO,1990,6398,6397,800,2143,950,406,17094
Lesotho,LSO,1991,6700,6451,751,2142,920,470,17434
Lesotho,LSO,1992,7184,6554,693,2139,922,530,18022
Lesotho,LSO,1993,7883,6645,639,2135,921,576,18799
Lesotho,LSO,1994,8832,6799,583,2132,933,612,19891
Lesotho,LSO,1995,9981,6906,527,2123,938,613,21088
Lesotho,LSO,1996,11410,6998,478,2103,947,617,22553
Lesotho,LSO,1997,13138,7138,442,2073,975,641,24407
Lesotho,LSO,1998,15157,7480,420,2038,1043,786,26924
Lesotho,LSO,1999,17244,7823,409,2004,1117,739,29336
Lesotho,LSO,2000,19361,8322,419,1985,1217,752,32056
Lesotho,LSO,2001,21045,8552,429,1951,1284,766,34027
Lesotho,LSO,2002,22651,8901,429,1925,1368,785,36059
Lesotho,LSO,2003,24219,9295,433,1906,1453,797,38103
Lesotho,LSO,2004,25455,9567,438,1885,1534,807,39686
Lesotho,LSO,2005,25790,9740,439,1862,1590,809,40230
Lesotho,LSO,2006,25128,9801,438,1823,1633,802,39625
Lesotho,LSO,2007,23322,9851,443,1827,1671,801,37915
Lesotho,LSO,2008,21310,9964,459,1824,1719,804,36080
Lesotho,LSO,2009,20020,9962,461,1718,1746,810,34717
Lesotho,LSO,2010,19187,10094,457,1642,1787,817,33984
Lesotho,LSO,2011,19272,10162,467,1610,1846,816,34173
Lesotho,LSO,2012,19929,10377,456,1580,1866,829,35037
Lesotho,LSO,2013,20378,10569,428,1523,1887,832,35617
Lesotho,LSO,2014,20609,10701,411,1477,1917,836,35951
Lesotho,LSO,2015,20104,10728,408,1451,1925,842,35458
Lesotho,LSO,2016,18792,10608,395,1390,1902,837,33924
Lesotho,LSO,2017,17580,10503,390,1338,1885,842,32538
Lesotho,LSO,2018,17077,10521,388,1296,1887,852,32021
Lesotho,LSO,2019,16949,10610,382,1283,1892,866,31982
Liberia,LBR,1990,15759,7342,2396,3922,777,3887,34083
Liberia,LBR,1991,15766,7541,2328,4038,779,737,31189
Liberia,LBR,1992,16342,7657,2415,3967,782,650,31813
Liberia,LBR,1993,16559,7721,2436,3817,771,2832,34136
Liberia,LBR,1994,16780,7810,2363,3782,764,4437,35936
Liberia,LBR,1995,17623,7798,2274,3892,743,2450,34780
Liberia,LBR,1996,19030,8098,2284,4177,807,3281,37677
Liberia,LBR,1997,19979,8056,2222,4308,807,198,35570
Liberia,LBR,1998,20467,8069,2172,4383,825,207,36123
Liberia,LBR,1999,20548,8000,2083,4456,805,325,36217
Liberia,LBR,2000,20191,8049,1988,4416,785,294,35723
Liberia,LBR,2001,19531,7957,1810,4277,752,659,34986
Liberia,LBR,2002,18531,7986,1606,4066,722,2453,35364
Liberia,LBR,2003,17791,7979,1411,3951,707,3445,35284
Liberia,LBR,2004,17068,8070,1239,3923,702,180,31182
Liberia,LBR,2005,17305,8245,1204,3935,732,173,31594
Liberia,LBR,2006,16793,8543,1131,3925,753,175,31320
Liberia,LBR,2007,16362,8749,1062,3887,775,183,31018
Liberia,LBR,2008,15996,9000,1026,3809,791,215,30837
Liberia,LBR,2009,15635,9332,1021,3832,842,205,30867
Liberia,LBR,2010,15178,9649,1000,3875,884,221,30807
Liberia,LBR,2011,14952,9845,981,3797,899,235,30709
Liberia,LBR,2012,14216,10156,986,3700,931,229,30218
Liberia,LBR,2013,13692,10299,927,3564,937,233,29652
Liberia,LBR,2014,13547,10209,843,3451,916,235,29201
Liberia,LBR,2015,13355,10307,788,3334,904,230,28918
Liberia,LBR,2016,13329,10371,735,3241,897,243,28816
Liberia,LBR,2017,12892,10486,671,3094,885,231,28259
Liberia,LBR,2018,12362,10731,634,3012,908,231,27878
Liberia,LBR,2019,12110,11000,623,2953,955,242,27883
Libya,LBY,2007,910,15536,26,840,2258,305,19875
Libya,LBY,2008,936,16175,27,782,2427,374,20721
Libya,LBY,2009,963,17087,29,721,2550,344,21694
Libya,LBY,2010,948,17078,29,665,2556,348,21624
Libya,LBY,1990,1397,10837,46,2905,1993,179,17357
Libya,LBY,1991,1305,10867,43,2740,1973,180,17108
Libya,LBY,1992,1217,10803,42,2539,1975,184,16760
Libya,LBY,1993,1155,10897,40,2345,1967,188,16592
Libya,LBY,1994,1098,10984,34,2160,1965,192,16433
Libya,LBY,1995,1046,11047,32,1971,1982,196,16274
Libya,LBY,1996,985,11114,32,1788,1972,2651,18542
Libya,LBY,1997,965,11599,30,1669,2045,219,16527
Libya,LBY,1998,953,12209,30,1551,2058,222,17023
Libya,LBY,1999,942,12653,30,1454,2086,230,17395
Libya,LBY,2000,932,12999,30,1371,2139,293,17764
Libya,LBY,2001,932,13363,30,1290,2180,255,18050
Libya,LBY,2002,935,13778,28,1219,2228,267,18455
Libya,LBY,2003,915,13794,26,1142,2216,272,18365
Libya,LBY,2004,871,13422,28,1054,2079,269,17723
Libya,LBY,2005,851,13565,26,971,2015,271,17699
Libya,LBY,2006,851,13966,24,894,2042,280,18057
Libya,LBY,2011,963,17583,28,607,2594,6139,27914
Libya,LBY,2012,952,17967,27,545,2530,767,22788
Libya,LBY,2013,959,18699,27,508,2555,469,23217
Libya,LBY,2014,991,19691,27,481,2578,5178,28946
Libya,LBY,2015,1016,20599,27,460,2575,3180,27857
Libya,LBY,2016,1055,21616,31,442,2588,4200,29932
Libya,LBY,2017,1095,22678,30,419,2641,1973,28836
Libya,LBY,2018,1131,23727,31,395,2689,1877,29850
Libya,LBY,2019,1164,24770,32,376,2730,1466,30538
Lithuania,LTU,1990,738,31936,34,276,2996,1384,37364
Lithuania,LTU,1991,801,33308,31,320,3273,1569,39302
Lithuania,LTU,1992,818,33082,23,329,3294,1730,39276
Lithuania,LTU,1993,939,36279,14,290,3718,2029,43269
Lithuania,LTU,1994,1044,37187,11,248,3912,2249,44651
Lithuania,LTU,1995,1057,36386,9,209,3794,2226,43681
Lithuania,LTU,1996,967,34491,6,169,3485,2002,41120
Lithuania,LTU,1997,918,33121,6,149,3267,1789,39250
Lithuania,LTU,1998,942,33344,6,131,3237,1615,39275
Lithuania,LTU,1999,944,32705,6,115,3155,1493,38418
Lithuania,LTU,2000,921,32325,6,100,3057,1448,37857
Lithuania,LTU,2001,966,33940,6,89,3169,1569,39739
Lithuania,LTU,2002,984,33954,6,84,3044,1419,39491
Lithuania,LTU,2003,1021,34525,6,79,2936,1480,40047
Lithuania,LTU,2004,1062,34857,6,79,2850,1488,40342
Lithuania,LTU,2005,1135,37115,6,76,2947,1599,42878
Lithuania,LTU,2006,1182,38395,6,73,2919,1633,44208
Lithuania,LTU,2007,1236,39645,7,72,2911,1659,45530
Lithuania,LTU,2008,1147,38777,7,69,2604,1550,44154
Lithuania,LTU,2009,992,36130,6,62,2210,1325,40725
Lithuania,LTU,2010,959,36556,6,59,2104,1341,41025
Lithuania,LTU,2011,917,36327,6,54,1991,1184,40479
Lithuania,LTU,2012,891,36191,6,47,1917,1158,40210
Lithuania,LTU,2013,906,36769,7,43,1891,1085,40701
Lithuania,LTU,2014,876,35900,7,44,1761,1013,39601
Lithuania,LTU,2015,882,36672,7,46,1690,994,40291
Lithuania,LTU,2016,887,36605,7,42,1606,961,40108
Lithuania,LTU,2017,811,34952,8,34,1414,874,38093
Lithuania,LTU,2018,793,35122,7,33,1379,908,38242
Lithuania,LTU,2019,775,34980,6,31,1347,919,38058
Luxembourg,LUX,1990,104,3421,7,17,165,37,3751
Luxembourg,LUX,1991,107,3421,7,17,163,39,3754
Luxembourg,LUX,1992,110,3393,7,16,161,42,3729
Luxembourg,LUX,1993,113,3390,8,15,160,46,3732
Luxembourg,LUX,1994,112,3356,8,14,158,47,3695
Luxembourg,LUX,1995,115,3351,8,13,154,46,3687
Luxembourg,LUX,1996,116,3342,8,13,152,46,3677
Luxembourg,LUX,1997,117,3319,8,12,145,45,3646
Luxembourg,LUX,1998,120,3310,8,13,137,46,3634
Luxembourg,LUX,1999,125,3296,8,12,133,45,3619
Luxembourg,LUX,2000,128,3308,9,11,132,46,3634
Luxembourg,LUX,2001,130,3252,9,11,125,45,3572
Luxembourg,LUX,2002,136,3252,9,10,123,46,3576
Luxembourg,LUX,2003,137,3226,9,9,118,46,3545
Luxembourg,LUX,2004,137,3250,10,8,114,46,3565
Luxembourg,LUX,2005,136,3257,10,7,112,45,3567
Luxembourg,LUX,2006,136,3270,10,7,110,46,3579
Luxembourg,LUX,2007,136,3250,10,6,106,45,3553
Luxembourg,LUX,2008,136,3229,10,6,103,45,3529
Luxembourg,LUX,2009,137,3257,11,6,102,45,3558
Luxembourg,LUX,2010,138,3288,11,6,102,46,3591
Luxembourg,LUX,2011,138,3303,12,6,103,46,3608
Luxembourg,LUX,2012,139,3332,12,6,103,47,3639
Luxembourg,LUX,2013,140,3363,12,7,103,47,3672
Luxembourg,LUX,2014,140,3361,13,7,106,49,3676
Luxembourg,LUX,2015,144,3352,13,7,107,49,3672
Luxembourg,LUX,2016,144,3331,14,7,108,50,3654
Luxembourg,LUX,2017,149,3430,14,7,110,50,3760
Luxembourg,LUX,2018,153,3527,14,6,111,51,3862
Luxembourg,LUX,2019,159,3635,15,6,113,52,3980
Madagascar,MDG,1990,61303,39938,24238,13774,4263,728,144244
Madagascar,MDG,1991,61411,40490,23882,13919,4316,726,144744
Madagascar,MDG,1992,61430,40985,23690,14136,4282,740,145263
Madagascar,MDG,1993,62108,42503,23560,14401,4399,744,147715
Madagascar,MDG,1994,61351,41744,23178,14449,4512,733,145967
Madagascar,MDG,1995,60029,43685,21530,14199,3829,692,143964
Madagascar,MDG,1996,60153,44285,20912,14406,3886,721,144363
Madagascar,MDG,1997,60121,44968,20209,14756,4114,761,144929
Madagascar,MDG,1998,60073,45872,19437,14994,4032,829,145237
Madagascar,MDG,1999,60491,45758,18589,15114,4008,925,144885
Madagascar,MDG,2000,59716,46066,17888,15334,4161,1093,144258
Madagascar,MDG,2001,59814,46359,17343,15514,4022,1054,144106
Madagascar,MDG,2002,59866,47644,17084,15845,4149,1154,145742
Madagascar,MDG,2003,60520,48720,16533,16033,4287,1090,147183
Madagascar,MDG,2004,60610,49366,16023,16200,4604,1078,147881
Madagascar,MDG,2005,62746,49825,16558,16298,4410,1084,150921
Madagascar,MDG,2006,62941,50201,16146,16306,4310,1076,150980
Madagascar,MDG,2007,62426,50849,15833,16257,4439,1085,150889
Madagascar,MDG,2008,61258,52621,15992,16397,4612,1111,151991
Madagascar,MDG,2009,60799,54146,15788,16483,4648,1281,153145
Madagascar,MDG,2010,59823,55319,14945,16459,4767,1130,152443
Madagascar,MDG,2011,59901,56574,14727,16361,4773,1138,153474
Madagascar,MDG,2012,59201,57846,14259,16252,4905,1166,153629
Madagascar,MDG,2013,58596,59063,13478,16061,4880,1254,153332
Madagascar,MDG,2014,58793,60433,13278,15862,4928,1605,154899
Madagascar,MDG,2015,58217,61968,12749,15651,5101,1348,155034
Madagascar,MDG,2016,57121,63761,12109,15424,5073,1365,154853
Madagascar,MDG,2017,56861,65796,11715,15137,5229,1267,156005
Madagascar,MDG,2018,55983,68028,11005,14987,5329,1363,156695
Madagascar,MDG,2019,55039,70004,10389,14852,5295,1383,156962
Malawi,MWI,1990,87425,27731,11937,15694,3403,688,146878
Malawi,MWI,1991,93442,28371,11998,15973,3967,709,154460
Malawi,MWI,1992,99564,29017,11999,16068,3551,760,160959
Malawi,MWI,1993,105517,29331,11788,15567,3543,727,166473
Malawi,MWI,1994,109558,29819,11351,15025,3509,722,169984
Malawi,MWI,1995,112788,30369,10708,14981,3504,724,173074
Malawi,MWI,1996,116901,30984,10040,15168,3505,731,177329
Malawi,MWI,1997,120726,31648,9480,15341,3540,742,181477
Malawi,MWI,1998,124241,32600,9050,15537,3564,758,185750
Malawi,MWI,1999,130181,33233,9298,15658,3695,784,192849
Malawi,MWI,2000,129281,33585,9117,15678,3710,800,192171
Malawi,MWI,2001,129795,33395,8522,15581,3723,813,191829
Malawi,MWI,2002,127695,33668,8952,15509,3630,833,190287
Malawi,MWI,2003,125357,34023,7448,15422,3642,857,186749
Malawi,MWI,2004,121920,34306,6737,15260,3599,869,182691
Malawi,MWI,2005,117753,34196,6219,15076,3535,876,177655
Malawi,MWI,2006,112535,34236,5916,14874,3509,878,171948
Malawi,MWI,2007,104971,34216,5463,14659,3469,875,163653
Malawi,MWI,2008,95653,34429,5053,14451,3419,867,153872
Malawi,MWI,2009,87953,35136,5015,14259,3518,876,146757
Malawi,MWI,2010,80410,36097,5051,14061,3612,892,140123
Malawi,MWI,2011,73894,36812,5273,13871,3739,903,134492
Malawi,MWI,2012,66869,37208,5171,13535,3744,892,127419
Malawi,MWI,2013,61628,37579,4972,13203,3744,880,122006
Malawi,MWI,2014,58570,38133,4791,12803,3749,874,118920
Malawi,MWI,2015,56681,38986,4670,12438,4072,885,117732
Malawi,MWI,2016,54560,39902,4445,12199,3820,888,115814
Malawi,MWI,2017,52084,40809,4232,11652,3815,869,113461
Malawi,MWI,2018,50124,42004,4173,11471,3912,881,112565
Malawi,MWI,2019,48635,43211,4041,11371,4022,873,112153
Malaysia,MYS,2007,15680,85000,336,1667,8264,1104,112051
Malaysia,MYS,2008,17333,88557,350,1762,8637,1130,117769
Malaysia,MYS,2010,20340,92376,361,1599,8989,1146,124811
Malaysia,MYS,2013,23259,94151,357,1512,8741,1146,129166
Malaysia,MYS,2014,24625,99267,375,1731,9124,1081,136203
Malaysia,MYS,2015,25260,103535,393,1900,9403,1084,141575
Malaysia,MYS,2016,26057,109795,415,1679,9709,1099,148754
Malaysia,MYS,1990,9026,55991,288,3899,6262,653,76119
Malaysia,MYS,1991,9204,56671,298,3768,6301,673,76915
Malaysia,MYS,1992,9714,58217,316,3810,6410,695,79162
Malaysia,MYS,1993,10372,60912,343,3730,6630,717,82704
Malaysia,MYS,1994,11303,65434,384,3516,6802,752,88191
Malaysia,MYS,1995,12160,69702,405,3389,7355,813,93824
Malaysia,MYS,1996,11978,69023,373,3017,7803,856,93050
Malaysia,MYS,1997,11986,69120,354,3010,7651,909,93030
Malaysia,MYS,1998,11871,69443,334,2723,7618,930,92919
Malaysia,MYS,1999,12862,77656,360,2847,8416,1011,103152
Malaysia,MYS,2000,12404,76036,335,2220,7839,1006,99840
Malaysia,MYS,2001,12813,77698,337,1924,7636,1021,101429
Malaysia,MYS,2002,13170,79879,347,1846,7669,1035,103946
Malaysia,MYS,2003,13460,81753,343,1828,8087,1083,106554
Malaysia,MYS,2004,13586,81603,329,1798,8214,1091,106621
Malaysia,MYS,2005,14078,82381,332,1774,8131,1101,107797
Malaysia,MYS,2006,14758,83840,332,1640,8168,1102,109840
Malaysia,MYS,2009,19115,91688,367,1862,9046,1153,123231
Malaysia,MYS,2011,21784,93810,359,1617,9076,1127,127773
Malaysia,MYS,2012,23054,95001,367,1690,9094,1116,130322
Malaysia,MYS,2017,26170,114765,434,1682,9967,1097,154115
Malaysia,MYS,2018,26175,119591,445,1635,10081,1098,159025
Malaysia,MYS,2019,27083,127016,469,1574,10481,1110,167733
Maldives,MDV,1990,156,642,73,264,82,4,1221
Maldives,MDV,1991,149,665,64,252,77,4,1211
Maldives,MDV,1992,140,685,54,240,74,4,1197
Maldives,MDV,1993,132,689,45,228,70,4,1168
Maldives,MDV,1994,122,681,36,216,68,4,1127
Maldives,MDV,1995,113,693,31,202,66,4,1109
Maldives,MDV,1996,107,723,27,186,65,4,1112
Maldives,MDV,1997,102,737,22,172,63,5,1101
Maldives,MDV,1998,93,719,18,160,62,5,1057
Maldives,MDV,1999,84,707,14,149,65,7,1026
Maldives,MDV,2000,78,725,12,139,61,7,1022
Maldives,MDV,2001,74,742,10,130,56,8,1020
Maldives,MDV,2002,66,721,9,123,53,8,980
Maldives,MDV,2003,62,720,8,116,49,7,962
Maldives,MDV,2004,59,714,7,110,150,7,1047
Maldives,MDV,2005,59,717,7,108,48,7,946
Maldives,MDV,2006,58,729,7,107,49,7,957
Maldives,MDV,2007,55,740,7,106,49,7,964
Maldives,MDV,2008,54,755,7,106,49,8,979
Maldives,MDV,2009,53,777,7,106,50,9,1002
Maldives,MDV,2010,53,798,7,107,51,10,1026
Maldives,MDV,2011,53,821,7,105,51,10,1047
Maldives,MDV,2012,53,847,7,103,52,11,1073
Maldives,MDV,2013,53,875,7,102,53,11,1101
Maldives,MDV,2014,55,906,7,100,56,12,1136
Maldives,MDV,2015,57,933,7,99,57,13,1166
Maldives,MDV,2016,59,982,7,98,59,13,1218
Maldives,MDV,2017,61,1030,7,94,63,13,1268
Maldives,MDV,2018,62,1086,8,87,64,13,1320
Maldives,MDV,2019,63,1141,8,82,67,13,1374
Mali,MLI,1990,68063,28311,15110,24220,3482,2029,141215
Mali,MLI,1991,67940,28532,15404,24215,3464,1725,141280
Mali,MLI,1992,68143,29029,15779,24259,3476,1535,142221
Mali,MLI,1993,68291,29414,16082,24284,3477,1455,143003
Mali,MLI,1994,68919,30012,16375,24412,3518,2331,145567
Mali,MLI,1995,70618,30643,16975,24526,3528,1508,147798
Mali,MLI,1996,72278,31097,17898,24493,3531,1524,150821
Mali,MLI,1997,73364,31358,19125,24319,3503,6545,158214
Mali,MLI,1998,73268,31458,20066,24094,3463,11523,163872
Mali,MLI,1999,74304,31649,20467,23904,3456,3590,157370
Mali,MLI,2000,75582,32229,20745,23957,3515,3548,159576
Mali,MLI,2001,75519,32580,20595,24036,3522,3560,159812
Mali,MLI,2002,78878,33504,22137,24309,3775,3640,166243
Mali,MLI,2003,79287,33981,21451,24739,3835,3159,166452
Mali,MLI,2004,79139,34622,20510,25413,3854,1676,165214
Mali,MLI,2005,79237,35291,19719,26117,3905,1693,165962
Mali,MLI,2006,78943,35997,19014,26815,3972,1919,166660
Mali,MLI,2007,76319,36900,17810,27481,4044,1836,164390
Mali,MLI,2008,76773,37869,17791,28272,4199,1983,166887
Mali,MLI,2009,75731,38858,17458,28983,4353,2091,167474
Mali,MLI,2010,74249,39622,16821,29536,4377,2033,166638
Mali,MLI,2011,73640,40176,16487,29924,4359,2053,166639
Mali,MLI,2012,77102,40848,16244,30388,4457,2506,171545
Mali,MLI,2013,78078,41707,17951,31234,4479,3275,176724
Mali,MLI,2014,77047,42673,19891,32027,4547,2536,178721
Mali,MLI,2015,73173,44239,22729,32905,4717,2655,180418
Mali,MLI,2016,69125,46270,28396,33921,5195,2773,185680
Mali,MLI,2017,63925,47891,33201,34720,5381,3510,188628
Mali,MLI,2018,63996,48967,30867,35195,5423,4859,189307
Mali,MLI,2019,63871,49946,29400,35526,5456,4303,188502
Malta,MLT,1990,102,2405,1,29,55,11,2603
Malta,MLT,1991,105,2409,1,28,56,14,2613
Malta,MLT,1992,111,2419,1,27,57,14,2629
Malta,MLT,1993,113,2413,1,25,57,13,2622
Malta,MLT,1994,118,2397,1,24,57,14,2611
Malta,MLT,1995,126,2430,1,22,57,15,2651
Malta,MLT,1996,131,2467,1,23,56,14,2692
Malta,MLT,1997,138,2504,1,20,56,14,2733
Malta,MLT,1998,145,2506,1,18,56,15,2741
Malta,MLT,1999,154,2560,1,17,54,15,2801
Malta,MLT,2000,159,2595,1,14,53,15,2837
Malta,MLT,2001,162,2628,1,13,53,15,2872
Malta,MLT,2002,166,2681,1,12,53,15,2928
Malta,MLT,2003,163,2706,2,12,54,16,2953
Malta,MLT,2004,159,2702,2,12,53,16,2944
Malta,MLT,2005,154,2697,2,12,52,16,2933
Malta,MLT,2006,152,2704,2,13,54,17,2942
Malta,MLT,2007,153,2736,2,13,53,17,2974
Malta,MLT,2008,156,2773,2,14,52,18,3015
Malta,MLT,2009,158,2807,2,14,51,18,3050
Malta,MLT,2010,158,2834,2,14,50,18,3076
Malta,MLT,2011,162,2900,2,13,51,18,3146
Malta,MLT,2012,167,2944,2,13,50,18,3194
Malta,MLT,2013,172,2967,2,13,49,17,3220
Malta,MLT,2014,174,3009,2,14,48,18,3265
Malta,MLT,2015,176,2996,2,13,46,18,3251
Malta,MLT,2016,183,3088,2,13,46,18,3350
Malta,MLT,2017,189,3156,2,12,46,18,3423
Malta,MLT,2018,192,3226,2,12,45,18,3495
Malta,MLT,2019,199,3314,2,11,45,19,3590
Marshall Islands,MHL,1990,47,176,6,21,24,4,278
Marshall Islands,MHL,1991,48,183,6,21,25,4,287
Marshall Islands,MHL,1992,48,186,6,21,25,4,290
Marshall Islands,MHL,1993,48,189,6,21,25,5,294
Marshall Islands,MHL,1994,46,181,4,21,25,5,282
Marshall Islands,MHL,1995,46,186,4,21,25,5,287
Marshall Islands,MHL,1996,47,190,4,21,25,5,292
Marshall Islands,MHL,1997,47,197,4,22,28,5,303
Marshall Islands,MHL,1998,48,203,5,22,28,5,311
Marshall Islands,MHL,1999,50,205,5,22,28,5,315
Marshall Islands,MHL,2000,55,211,5,23,28,5,327
Marshall Islands,MHL,2001,50,216,4,23,29,5,327
Marshall Islands,MHL,2002,48,223,4,23,31,5,334
Marshall Islands,MHL,2003,49,228,4,22,31,5,339
Marshall Islands,MHL,2004,48,233,4,22,31,5,343
Marshall Islands,MHL,2005,47,239,4,22,31,5,348
Marshall Islands,MHL,2006,45,247,4,21,31,5,353
Marshall Islands,MHL,2007,45,250,4,20,31,5,355
Marshall Islands,MHL,2008,43,255,4,19,31,5,357
Marshall Islands,MHL,2009,42,259,4,18,31,5,359
Marshall Islands,MHL,2010,41,264,4,17,31,5,362
Marshall Islands,MHL,2011,39,270,4,16,31,5,365
Marshall Islands,MHL,2012,38,273,4,15,30,5,365
Marshall Islands,MHL,2013,38,280,4,15,30,5,372
Marshall Islands,MHL,2014,38,285,2,14,30,5,374
Marshall Islands,MHL,2015,38,292,2,13,30,5,380
Marshall Islands,MHL,2016,37,298,2,13,30,5,385
Marshall Islands,MHL,2017,37,307,2,12,30,5,393
Marshall Islands,MHL,2018,38,314,2,12,30,5,401
Marshall Islands,MHL,2019,38,321,2,12,30,5,408
Mauritania,MRT,1990,7121,7184,1878,3429,1094,205,20911
Mauritania,MRT,1991,7200,7178,1777,3442,1093,179,20869
Mauritania,MRT,1992,7235,7236,1707,3451,1096,183,20908
Mauritania,MRT,1993,7284,7326,1602,3455,1102,189,20958
Mauritania,MRT,1994,7703,7183,1462,3435,1072,187,21042
Mauritania,MRT,1995,7933,7072,1339,3398,1051,188,20981
Mauritania,MRT,1996,8246,7119,1366,3380,1084,197,21392
Mauritania,MRT,1997,8254,7118,1296,3367,1084,206,21325
Mauritania,MRT,1998,8211,7248,1270,3366,1106,210,21411
Mauritania,MRT,1999,8382,7131,1193,3339,1086,209,21340
Mauritania,MRT,2000,8189,7194,1123,3321,1091,215,21133
Mauritania,MRT,2001,7984,7321,1004,3294,1104,223,20930
Mauritania,MRT,2002,7779,7401,926,3266,1128,228,20728
Mauritania,MRT,2003,7682,7431,795,3252,1083,243,20486
Mauritania,MRT,2004,7195,7605,729,3276,1082,233,20120
Mauritania,MRT,2005,7313,7678,682,3281,1106,287,20347
Mauritania,MRT,2006,6813,7891,627,3272,1133,244,19980
Mauritania,MRT,2007,6790,7866,523,3225,1096,244,19744
Mauritania,MRT,2008,6708,7936,451,3169,1067,262,19593
Mauritania,MRT,2009,6317,8227,422,3158,1106,253,19483
Mauritania,MRT,2010,6179,8271,374,3105,1081,252,19262
Mauritania,MRT,2011,6029,8461,389,3061,1085,267,19292
Mauritania,MRT,2012,5866,8795,404,3021,1134,269,19489
Mauritania,MRT,2013,5717,9003,419,2964,1193,268,19564
Mauritania,MRT,2014,5918,8929,430,2863,1142,258,19540
Mauritania,MRT,2015,5992,9118,463,2779,1111,264,19727
Mauritania,MRT,2016,6100,9159,509,2660,1092,262,19782
Mauritania,MRT,2017,5747,9509,610,2566,1131,270,19833
Mauritania,MRT,2018,5905,9639,565,2467,1093,268,19937
Mauritania,MRT,2019,6079,9817,541,2392,1091,267,20187
Mauritius,MUS,1990,443,5611,43,312,407,94,6910
Mauritius,MUS,1991,417,5578,34,294,408,101,6832
Mauritius,MUS,1992,414,5768,28,301,418,101,7030
Mauritius,MUS,1993,420,6001,25,296,441,101,7284
Mauritius,MUS,1994,416,6125,19,279,449,100,7388
Mauritius,MUS,1995,402,6170,17,283,451,97,7420
Mauritius,MUS,1996,386,6314,15,299,451,101,7566
Mauritius,MUS,1997,386,6668,13,283,450,93,7893
Mauritius,MUS,1998,354,6559,13,259,432,86,7703
Mauritius,MUS,1999,340,6704,13,250,436,83,7826
Mauritius,MUS,2000,326,6781,13,211,417,79,7827
Mauritius,MUS,2001,305,6893,14,188,404,79,7883
Mauritius,MUS,2002,304,7108,17,177,413,86,8105
Mauritius,MUS,2003,297,7271,17,166,388,94,8233
Mauritius,MUS,2004,293,7289,19,165,380,104,8250
Mauritius,MUS,2005,293,7513,19,159,370,115,8469
Mauritius,MUS,2006,295,7574,21,152,366,128,8536
Mauritius,MUS,2007,304,7473,26,153,365,125,8446
Mauritius,MUS,2008,307,7736,30,141,364,137,8715
Mauritius,MUS,2009,315,7924,33,129,370,136,8907
Mauritius,MUS,2010,355,7908,32,117,362,142,8916
Mauritius,MUS,2011,356,7855,29,119,366,133,8858
Mauritius,MUS,2012,383,8012,31,122,353,125,9026
Mauritius,MUS,2013,408,8028,31,111,356,129,9063
Mauritius,MUS,2014,427,8287,32,113,344,121,9324
Mauritius,MUS,2015,412,8447,31,107,350,125,9472
Mauritius,MUS,2016,453,8734,30,102,347,124,9790
Mauritius,MUS,2017,435,9039,32,105,345,134,10090
Mauritius,MUS,2018,432,9347,32,98,341,127,10377
Mauritius,MUS,2019,431,9569,32,94,336,126,10588
Mexico,MEX,1990,69508,243679,23769,39323,29412,22836,428527
Mexico,MEX,1991,64888,248544,23446,38545,29186,23112,427721
Mexico,MEX,1992,61186,256273,23040,37810,29114,23348,430771
Mexico,MEX,1993,58055,265852,22707,36997,29110,23314,436035
Mexico,MEX,1994,54328,274213,22186,36144,28640,23615,439126
Mexico,MEX,1995,52017,285171,22027,35335,28420,23049,446019
Mexico,MEX,1996,49501,292780,21522,34194,28093,22272,448362
Mexico,MEX,1997,46214,301788,20742,33078,28786,21562,452170
Mexico,MEX,1998,42635,309368,19811,32048,29242,21615,454719
Mexico,MEX,1999,39450,313281,18555,30981,28419,20030,450716
Mexico,MEX,2000,36595,316533,17288,29791,27637,18968,446812
Mexico,MEX,2001,34931,323668,16500,28655,27223,18142,449119
Mexico,MEX,2002,34063,338605,16121,27672,27656,18024,462141
Mexico,MEX,2003,33486,352783,15738,26671,28057,17959,474694
Mexico,MEX,2004,32638,357767,14975,25596,27878,17257,476111
Mexico,MEX,2005,32423,374213,14683,24716,28673,17807,492515
Mexico,MEX,2006,31807,378508,14056,23686,28734,18175,494966
Mexico,MEX,2007,31623,387584,13812,22853,29169,17655,502696
Mexico,MEX,2008,32326,412596,13947,22096,30399,21003,532367
Mexico,MEX,2009,32906,433650,14083,21423,31108,24151,557321
Mexico,MEX,2010,32500,438822,13878,20521,30422,26171,562314
Mexico,MEX,2011,32365,445514,13524,19732,29720,28277,569132
Mexico,MEX,2012,32574,460470,13399,18990,29408,28083,582924
Mexico,MEX,2013,33669,490787,13704,18158,30321,28353,614992
Mexico,MEX,2014,34094,507726,13478,17304,30320,27689,630611
Mexico,MEX,2015,34174,520502,13212,16460,30424,28614,643386
Mexico,MEX,2016,34424,538043,13013,15468,31216,31191,663355
Mexico,MEX,2017,35326,565752,13229,14651,33257,36830,699045
Mexico,MEX,2018,35499,581511,13768,14025,33072,36857,714732
Mexico,MEX,2019,35919,604939,14303,13403,32428,36410,737402
Micronesia,FSM,1990,131,520,14,53,64,12,794
Micronesia,FSM,1991,128,529,14,52,64,12,799
Micronesia,FSM,1992,125,536,14,51,65,12,803
Micronesia,FSM,1993,122,543,13,49,65,12,804
Micronesia,FSM,1994,119,548,12,48,66,13,806
Micronesia,FSM,1995,113,551,12,46,66,13,801
Micronesia,FSM,1996,110,557,12,45,66,13,803
Micronesia,FSM,1997,106,561,10,42,66,13,798
Micronesia,FSM,1998,103,565,10,40,66,13,797
Micronesia,FSM,1999,97,570,10,38,65,14,794
Micronesia,FSM,2000,113,573,9,36,63,14,808
Micronesia,FSM,2001,89,577,8,34,63,14,785
Micronesia,FSM,2002,85,582,8,30,109,15,829
Micronesia,FSM,2003,83,586,8,28,61,14,780
Micronesia,FSM,2004,81,593,8,27,62,14,785
Micronesia,FSM,2005,79,597,7,26,61,13,783
Micronesia,FSM,2006,80,602,6,24,61,13,786
Micronesia,FSM,2007,79,610,6,23,61,13,792
Micronesia,FSM,2008,79,618,6,21,60,13,797
Micronesia,FSM,2009,81,625,6,20,59,13,804
Micronesia,FSM,2010,81,631,6,19,58,13,808
Micronesia,FSM,2011,83,639,6,18,58,13,817
Micronesia,FSM,2012,85,646,6,17,58,13,825
Micronesia,FSM,2013,85,657,6,16,58,13,835
Micronesia,FSM,2014,89,669,6,15,58,13,850
Micronesia,FSM,2015,92,679,6,15,63,13,868
Micronesia,FSM,2016,96,689,6,13,58,13,875
Micronesia,FSM,2017,99,700,6,12,58,13,888
Micronesia,FSM,2018,102,714,6,12,58,13,905
Micronesia,FSM,2019,105,725,5,11,59,13,918
Moldova,MDA,1990,1746,37393,29,738,2672,1188,43766
Moldova,MDA,1991,1730,40248,22,679,2696,1304,46679
Moldova,MDA,1992,1637,38916,16,626,2443,2177,45815
Moldova,MDA,1993,1679,40933,15,578,2338,1584,47127
Moldova,MDA,1994,1929,46062,17,547,2606,1614,52775
Moldova,MDA,1995,2004,47316,19,530,2543,1723,54135
Moldova,MDA,1996,1943,44760,19,493,2313,1583,51111
Moldova,MDA,1997,1770,41079,15,462,2048,1437,46811
Moldova,MDA,1998,1699,39358,14,432,1937,1354,44794
Moldova,MDA,1999,1754,40269,14,397,1914,1355,45703
Moldova,MDA,2000,1810,40850,12,356,1882,1387,46297
Moldova,MDA,2001,1764,40955,10,314,1882,1362,46287
Moldova,MDA,2002,1810,42615,10,265,1893,1405,47998
Moldova,MDA,2003,1848,43776,8,244,1899,1426,49201
Moldova,MDA,2004,1883,43140,7,231,1911,1423,48595
Moldova,MDA,2005,2005,44753,7,223,2058,1533,50579
Moldova,MDA,2006,1948,43701,6,223,1997,1540,49415
Moldova,MDA,2007,1949,43770,6,235,1960,1523,49443
Moldova,MDA,2008,1895,43179,5,258,1901,1515,48753
Moldova,MDA,2009,1848,43090,5,260,1887,1513,48603
Moldova,MDA,2010,1839,44027,3,258,1924,1533,49584
Moldova,MDA,2011,1584,39681,3,241,1638,1330,44477
Moldova,MDA,2012,1520,39706,3,230,1597,1338,44394
Moldova,MDA,2013,1432,38761,3,219,1482,1246,43143
Moldova,MDA,2014,1488,40509,3,209,1503,1265,44977
Moldova,MDA,2015,1516,42267,3,204,1490,1249,46729
Moldova,MDA,2016,1443,41771,3,191,1394,1178,45980
Moldova,MDA,2017,1336,39810,3,175,1250,1045,43619
Moldova,MDA,2018,1291,39616,3,160,1199,1057,43326
Moldova,MDA,2019,1248,38863,3,148,1173,1048,42483
Monaco,MCO,1990,17,401,0,1,9,1,429
Monaco,MCO,1991,17,406,0,1,9,1,434
Monaco,MCO,1992,18,411,0,1,9,1,440
Monaco,MCO,1993,19,416,0,1,9,1,446
Monaco,MCO,1994,19,419,0,1,9,1,449
Monaco,MCO,1995,20,424,0,1,9,0,454
Monaco,MCO,1996,20,432,0,1,9,0,462
Monaco,MCO,1997,21,435,0,1,9,0,466
Monaco,MCO,1998,21,438,0,1,9,0,469
Monaco,MCO,1999,22,440,0,1,9,0,472
Monaco,MCO,2000,23,441,0,0,8,0,472
Monaco,MCO,2001,24,446,0,0,8,0,478
Monaco,MCO,2002,25,451,0,0,8,0,484
Monaco,MCO,2003,25,456,0,0,8,0,489
Monaco,MCO,2004,25,458,0,0,8,0,491
Monaco,MCO,2005,26,460,0,0,9,0,495
Monaco,MCO,2006,26,465,0,0,9,0,500
Monaco,MCO,2007,26,467,0,0,9,0,502
Monaco,MCO,2008,26,469,0,0,9,0,504
Monaco,MCO,2009,27,472,0,0,9,0,508
Monaco,MCO,2010,27,476,0,0,9,0,512
Monaco,MCO,2011,27,478,0,0,9,0,514
Monaco,MCO,2012,27,479,0,0,9,0,515
Monaco,MCO,2013,27,481,0,0,9,0,517
Monaco,MCO,2014,27,481,0,0,9,0,517
Monaco,MCO,2015,27,480,0,0,9,0,516
Monaco,MCO,2016,27,479,0,0,9,0,515
Monaco,MCO,2017,27,478,0,0,9,0,514
Monaco,MCO,2018,27,478,0,0,9,0,514
Monaco,MCO,2019,27,478,0,0,8,0,513
Mongolia,MNG,2007,1519,15319,19,1029,1491,1108,20485
Mongolia,MNG,2008,1441,15459,18,1042,1553,1116,20629
Mongolia,MNG,2009,1389,15957,18,1056,1526,1134,21080
Mongolia,MNG,1990,4913,12266,42,1546,867,657,20291
Mongolia,MNG,1991,4710,12662,41,1508,872,683,20476
Mongolia,MNG,1992,4595,13022,41,1471,982,745,20856
Mongolia,MNG,1993,4511,13243,40,1441,1081,793,21109
Mongolia,MNG,1994,4307,13500,38,1390,1106,983,21324
Mongolia,MNG,1995,4042,14129,37,1332,1141,863,21544
Mongolia,MNG,1996,3780,14569,36,1274,1229,883,21771
Mongolia,MNG,1997,3491,14599,34,1223,1160,889,21396
Mongolia,MNG,1998,3190,14623,30,1167,1129,877,21016
Mongolia,MNG,1999,2923,14757,28,1119,1130,869,20826
Mongolia,MNG,2000,2672,14933,27,1082,1183,873,20770
Mongolia,MNG,2001,2398,15213,26,1050,1218,872,20777
Mongolia,MNG,2002,2182,15190,24,1027,1255,892,20570
Mongolia,MNG,2003,2003,15195,22,1022,1330,927,20499
Mongolia,MNG,2004,1856,15141,21,1024,1402,989,20433
Mongolia,MNG,2005,1719,15269,20,1016,1455,1043,20522
Mongolia,MNG,2006,1611,15408,20,1017,1465,1079,20600
Mongolia,MNG,2010,1348,16344,17,1060,1530,1181,21480
Mongolia,MNG,2011,1317,16688,17,1043,1523,1185,21773
Mongolia,MNG,2012,1286,16794,17,1012,1512,1175,21796
Mongolia,MNG,2013,1244,16898,16,974,1501,1173,21806
Mongolia,MNG,2014,1192,16967,15,911,1501,1176,21762
Mongolia,MNG,2015,1092,17383,15,783,1498,1185,21956
Mongolia,MNG,2016,1052,18397,15,718,1506,1196,22884
Mongolia,MNG,2017,1059,19136,15,697,1534,1210,23651
Mongolia,MNG,2018,1031,19905,15,651,1531,1228,24361
Mongolia,MNG,2019,1004,20869,15,606,1534,1244,25272
Montenegro,MNE,1990,68,3791,2,100,196,47,4204
Montenegro,MNE,1991,66,3730,2,89,206,48,4141
Montenegro,MNE,1992,66,3832,2,85,205,48,4238
Montenegro,MNE,1993,69,4060,2,85,195,47,4458
Montenegro,MNE,1994,71,4282,2,85,196,48,4684
Montenegro,MNE,1995,73,4420,2,82,196,49,4822
Montenegro,MNE,1996,74,4573,2,81,198,50,4978
Montenegro,MNE,1997,76,4769,2,78,205,51,5181
Montenegro,MNE,1998,76,4809,2,74,219,53,5233
Montenegro,MNE,1999,79,4846,2,72,238,56,5293
Montenegro,MNE,2000,79,4927,2,73,232,56,5369
Montenegro,MNE,2001,78,5060,2,72,225,55,5492
Montenegro,MNE,2002,77,5211,2,66,218,52,5626
Montenegro,MNE,2003,78,5404,2,61,224,51,5820
Montenegro,MNE,2004,78,5564,2,55,228,50,5977
Montenegro,MNE,2005,80,5724,2,51,235,49,6141
Montenegro,MNE,2006,79,5831,2,46,238,48,6244
Montenegro,MNE,2007,78,5931,2,41,235,47,6334
Montenegro,MNE,2008,78,5978,2,39,227,46,6370
Montenegro,MNE,2009,78,6030,2,35,223,45,6413
Montenegro,MNE,2010,77,6039,2,33,212,43,6406
Montenegro,MNE,2011,77,6096,2,27,207,42,6451
Montenegro,MNE,2012,76,6129,2,25,204,41,6477
Montenegro,MNE,2013,78,6235,2,23,205,40,6583
Montenegro,MNE,2014,79,6352,2,22,205,41,6701
Montenegro,MNE,2015,80,6446,2,16,202,39,6785
Montenegro,MNE,2016,80,6479,2,16,203,39,6819
Montenegro,MNE,2017,80,6523,2,15,201,39,6860
Montenegro,MNE,2018,77,6456,2,14,199,40,6788
Montenegro,MNE,2019,76,6396,2,13,197,38,6722
Morocco,MAR,1990,34110,89130,907,21811,12854,756,159568
Morocco,MAR,1991,32446,91923,861,21606,12994,787,160617
Morocco,MAR,1992,31248,96754,860,21343,14574,831,165610
Morocco,MAR,1993,30081,100550,833,20886,15071,866,168287
Morocco,MAR,1994,28801,102272,819,20175,14983,893,167943
Morocco,MAR,1995,27860,104788,784,19758,15855,932,169977
Morocco,MAR,1996,26678,106515,760,19363,15116,973,169405
Morocco,MAR,1997,25694,109258,752,19137,15291,1033,171165
Morocco,MAR,1998,24622,111670,738,18759,15129,1084,172002
Morocco,MAR,1999,23807,115367,712,18365,15253,1140,174644
Morocco,MAR,2000,22741,114408,689,17888,14971,1162,171859
Morocco,MAR,2001,21954,115330,665,17288,14910,1195,171342
Morocco,MAR,2002,21317,117637,630,16828,14788,1206,172406
Morocco,MAR,2003,20851,122996,622,16272,14735,1302,176778
Morocco,MAR,2004,20338,126260,603,15666,15198,1228,179293
Morocco,MAR,2005,19788,129970,589,15106,14483,1230,181166
Morocco,MAR,2006,19237,134019,564,14421,14406,1239,183886
Morocco,MAR,2007,18773,138456,551,13571,14501,1250,187102
Morocco,MAR,2008,18466,141767,523,12989,14662,1259,189666
Morocco,MAR,2009,17984,144953,499,12353,14702,1263,191754
Morocco,MAR,2010,17279,147837,477,11654,14687,1279,193213
Morocco,MAR,2011,16520,150716,458,10865,14537,1278,194374
Morocco,MAR,2012,15919,154735,445,10241,14425,1260,197025
Morocco,MAR,2013,15815,170088,458,9570,13274,1215,210420
Morocco,MAR,2014,15349,172104,439,8899,13288,1224,211303
Morocco,MAR,2015,14781,174385,438,8210,13136,1223,212173
Morocco,MAR,2016,14262,177439,416,7516,13071,1221,213925
Morocco,MAR,2017,13800,181153,408,6825,13002,1216,216404
Morocco,MAR,2018,13286,185029,397,6176,12972,1211,219071
Morocco,MAR,2019,12835,188619,386,5702,12912,1204,221658
Mozambique,MOZ,1990,104409,33339,19854,21244,4891,3213,186950
Mozambique,MOZ,1991,103217,33481,19361,20818,4851,3436,185164
Mozambique,MOZ,1992,104103,34034,18994,21117,4860,1941,185049
Mozambique,MOZ,1993,106934,34858,18839,22484,5039,1318,189472
Mozambique,MOZ,1994,111543,35491,19090,24152,5432,1378,197086
Mozambique,MOZ,1995,117527,36057,19412,25257,5348,1442,205043
Mozambique,MOZ,1996,121311,36668,19016,25771,5454,1444,209664
Mozambique,MOZ,1997,125324,37457,18138,26239,5586,1457,214201
Mozambique,MOZ,1998,129761,38218,17339,26677,5721,1484,219200
Mozambique,MOZ,1999,134982,39071,16565,27080,5824,1508,225030
Mozambique,MOZ,2000,138731,40152,15751,27395,6766,1562,230357
Mozambique,MOZ,2001,143669,40242,14429,27338,5936,1593,233207
Mozambique,MOZ,2002,147718,41335,13286,27325,5880,1647,237191
Mozambique,MOZ,2003,151468,42203,12180,27261,5993,1705,240810
Mozambique,MOZ,2004,154032,43773,11340,27262,6123,1824,244354
Mozambique,MOZ,2005,156057,45618,10610,27377,6330,1986,247978
Mozambique,MOZ,2006,160689,47871,11434,27657,6875,2205,256731
Mozambique,MOZ,2007,157349,49716,11133,27833,7262,2416,255709
Mozambique,MOZ,2008,153525,52075,10597,27998,7579,2493,254267
Mozambique,MOZ,2009,155678,54026,9930,28041,7698,2538,257911
Mozambique,MOZ,2010,157503,56219,9277,27974,7876,2584,261433
Mozambique,MOZ,2011,157580,57989,8508,27813,7974,2579,262443
Mozambique,MOZ,2012,161023,59915,8383,27667,8213,2648,267849
Mozambique,MOZ,2013,159213,61532,8134,27513,8413,2749,267554
Mozambique,MOZ,2014,152619,62674,7926,27263,8442,2790,261714
Mozambique,MOZ,2015,146144,63663,7688,26970,8720,2807,255992
Mozambique,MOZ,2016,141514,64357,7169,26622,8574,2873,251109
Mozambique,MOZ,2017,137417,65371,6748,26325,8543,2952,247356
Mozambique,MOZ,2018,134953,66459,6572,26280,8608,3220,246092
Mozambique,MOZ,2019,135133,67790,6892,26389,9465,3141,248810
Myanmar,MMR,1990,159279,229745,11430,40396,22772,4859,468481
Myanmar,MMR,1991,156331,234966,11131,40299,23114,5555,471396
Myanmar,MMR,1992,154068,239376,10737,40060,23084,5980,473305
Myanmar,MMR,1993,151523,243670,10291,39716,23015,4248,472463
Myanmar,MMR,1994,148195,247571,9797,39176,22963,4902,472604
Myanmar,MMR,1995,144574,251327,9304,38596,22870,5638,472309
Myanmar,MMR,1996,141412,254930,8821,38228,22691,4682,470764
Myanmar,MMR,1997,138165,258399,8310,37855,22574,4717,470020
Myanmar,MMR,1998,135640,262065,7846,37492,22399,4431,469873
Myanmar,MMR,1999,133256,265423,7364,36966,22112,4112,469233
Myanmar,MMR,2000,129655,268831,6979,36105,21231,4382,467183
Myanmar,MMR,2001,126945,271991,6616,35111,20155,3921,464739
Myanmar,MMR,2002,124082,274865,6228,34214,19282,3957,462628
Myanmar,MMR,2003,122086,277477,5865,33318,18593,3599,460938
Myanmar,MMR,2004,118974,281561,5577,32389,18718,3485,460704
Myanmar,MMR,2005,115498,282086,5228,31383,17788,3694,455677
Myanmar,MMR,2006,111668,283900,4884,30421,17172,3569,451614
Myanmar,MMR,2007,108239,283069,4522,29314,16199,3667,445010
Myanmar,MMR,2008,106171,282153,4247,28206,153777,2969,577523
Myanmar,MMR,2009,99917,283330,3997,27103,14959,3054,432360
Myanmar,MMR,2010,94249,283252,3738,25930,14467,2906,424542
Myanmar,MMR,2011,87256,286128,3538,24876,14226,3493,419517
Myanmar,MMR,2012,82678,287374,3338,23780,13374,3654,414198
Myanmar,MMR,2013,75021,292174,3189,22928,13060,2976,409348
Myanmar,MMR,2014,68065,296531,3055,22054,12810,2844,405359
Myanmar,MMR,2015,62922,301148,2920,21235,13081,3212,404518
Myanmar,MMR,2016,58054,306672,2823,20567,12996,2794,403906
Myanmar,MMR,2017,54061,312578,2721,19494,12089,5031,405974
Myanmar,MMR,2018,51252,318043,2641,18481,11171,2541,404129
Myanmar,MMR,2019,49030,323036,2571,17718,11149,2945,406449
Namibia,NAM,1990,4018,4873,684,1162,589,291,11617
Namibia,NAM,1991,4162,5017,665,1156,605,305,11910
Namibia,NAM,1992,4411,5202,672,1148,625,316,12374
Namibia,NAM,1993,4885,5366,608,1138,636,325,12958
Namibia,NAM,1994,5664,5592,578,1132,664,342,13972
Namibia,NAM,1995,6300,5818,539,1124,693,359,14833
Namibia,NAM,1996,7342,6027,495,1113,727,379,16083
Namibia,NAM,1997,8485,6273,458,1110,768,400,17494
Namibia,NAM,1998,9853,6571,492,1115,836,458,19325
Namibia,NAM,1999,11086,6904,480,1127,903,479,20979
Namibia,NAM,2000,12303,7234,477,1136,973,603,22726
Namibia,NAM,2001,13459,7308,460,1137,985,497,23846
Namibia,NAM,2002,14462,7516,463,1142,1033,514,25130
Namibia,NAM,2003,15190,7568,449,1139,1041,518,25905
Namibia,NAM,2004,15273,7514,439,1129,1022,503,25880
Namibia,NAM,2005,14339,7436,451,1130,1013,510,24879
Namibia,NAM,2006,12890,7297,444,1135,980,504,23250
Namibia,NAM,2007,11092,7203,467,1153,961,508,21384
Namibia,NAM,2008,9742,7169,476,1152,980,511,20030
Namibia,NAM,2009,9177,7209,470,1151,1017,512,19536
Namibia,NAM,2010,8811,7284,481,1140,933,516,19165
Namibia,NAM,2011,8229,7269,467,1124,1009,505,18603
Namibia,NAM,2012,7645,7373,440,1087,890,502,17937
Namibia,NAM,2013,7545,7531,469,1061,915,506,18027
Namibia,NAM,2014,7735,7741,461,1052,942,511,18442
Namibia,NAM,2015,7803,7944,447,1039,962,517,18712
Namibia,NAM,2016,7766,8132,423,1029,977,515,18842
Namibia,NAM,2017,7680,8306,401,1015,987,516,18905
Namibia,NAM,2018,7243,8484,393,987,1001,522,18630
Namibia,NAM,2019,7060,8626,373,959,997,518,18533
Nauru,NRU,1990,9,45,2,6,7,1,70
Nauru,NRU,1991,9,46,2,6,7,1,71
Nauru,NRU,1992,9,46,2,5,7,1,70
Nauru,NRU,1993,9,47,2,6,7,1,72
Nauru,NRU,1994,9,47,2,6,7,1,72
Nauru,NRU,1995,9,49,2,6,8,1,75
Nauru,NRU,1996,10,51,2,6,8,1,78
Nauru,NRU,1997,10,51,2,6,9,1,79
Nauru,NRU,1998,10,52,2,6,9,1,80
Nauru,NRU,1999,10,54,2,6,9,1,82
Nauru,NRU,2000,11,54,2,7,9,1,84
Nauru,NRU,2001,11,56,2,7,9,1,86
Nauru,NRU,2002,11,56,2,7,9,1,86
Nauru,NRU,2003,10,56,2,7,9,1,85
Nauru,NRU,2004,10,56,2,7,9,1,85
Nauru,NRU,2005,10,54,2,6,9,1,82
Nauru,NRU,2006,10,54,2,6,9,1,82
Nauru,NRU,2007,10,54,2,6,9,1,82
Nauru,NRU,2008,10,53,2,6,9,1,81
Nauru,NRU,2009,8,53,2,6,9,1,79
Nauru,NRU,2010,8,50,2,6,8,1,75
Nauru,NRU,2011,8,50,2,5,8,1,74
Nauru,NRU,2012,7,49,0,5,8,1,70
Nauru,NRU,2013,7,49,0,4,8,1,69
Nauru,NRU,2014,7,47,0,4,7,1,66
Nauru,NRU,2015,6,47,0,3,7,1,64
Nauru,NRU,2016,6,46,0,3,6,1,62
Nauru,NRU,2017,6,46,0,3,6,1,62
Nauru,NRU,2018,6,47,0,3,6,1,63
Nauru,NRU,2019,6,47,0,3,6,1,63
Nepal,NPL,1990,70489,68072,17695,29357,8435,1398,195446
Nepal,NPL,1991,69114,68948,16205,28855,8282,1382,192786
Nepal,NPL,1992,65646,69547,14900,28366,8027,1387,187873
Nepal,NPL,1993,63455,71011,13767,27921,9318,1399,186871
Nepal,NPL,1994,60982,71708,12683,27344,7835,1405,181957
Nepal,NPL,1995,58541,72498,11695,26878,8061,1406,179079
Nepal,NPL,1996,56044,72762,10653,26308,8358,1483,175608
Nepal,NPL,1997,53430,73716,9668,25601,7481,1461,171357
Nepal,NPL,1998,50799,74584,8751,24824,7685,1757,168400
Nepal,NPL,1999,47956,75505,7906,24045,7420,1712,164544
Nepal,NPL,2000,45227,76722,7147,23310,7212,1845,161463
Nepal,NPL,2001,42796,77632,6469,22565,6974,2128,158564
Nepal,NPL,2002,40734,78847,5886,21788,7130,6358,160743
Nepal,NPL,2003,38864,80542,5393,20999,6795,3157,155750
Nepal,NPL,2004,37303,82973,5007,20302,6725,4499,156809
Nepal,NPL,2005,37482,85806,4985,19650,6814,3038,157775
Nepal,NPL,2006,36989,89010,4706,18995,7051,2138,158889
Nepal,NPL,2007,36041,92400,4529,18407,7276,1558,160211
Nepal,NPL,2008,34925,95736,4108,17666,7267,1629,161331
Nepal,NPL,2009,33995,99303,3792,16898,7392,1552,162932
Nepal,NPL,2010,32305,102982,3477,16126,7475,1545,163910
Nepal,NPL,2011,30800,107601,3189,15356,7580,1555,166081
Nepal,NPL,2012,29612,112114,2970,14472,7596,1520,168284
Nepal,NPL,2013,29161,116703,2899,13757,7817,1582,171919
Nepal,NPL,2014,28233,120569,2741,13045,8103,1535,174226
Nepal,NPL,2015,27454,124926,2635,12472,16765,1547,185799
Nepal,NPL,2016,26593,128619,2536,11834,7957,1551,179090
Nepal,NPL,2017,25894,132591,2463,11196,7962,1548,181654
Nepal,NPL,2018,24915,136430,2340,10585,7856,1587,183713
Nepal,NPL,2019,24322,140083,2288,10111,8035,1544,186383
Netherlands,NLD,1990,4660,111873,193,658,3864,494,121742
Netherlands,NLD,1991,4943,112565,208,627,3802,526,122671
Netherlands,NLD,1992,5420,113548,227,603,3755,558,124111
Netherlands,NLD,1993,6123,116331,254,598,3763,576,127645
Netherlands,NLD,1994,6439,115580,267,561,3685,578,127110
Netherlands,NLD,1995,6937,116169,278,541,3646,605,128176
Netherlands,NLD,1996,7255,117541,309,548,3607,634,129894
Netherlands,NLD,1997,7416,117344,331,521,3518,656,129786
Netherlands,NLD,1998,7727,118065,361,543,3469,672,130837
Netherlands,NLD,1999,8147,119456,404,551,3486,723,132767
Netherlands,NLD,2000,8342,119524,422,559,3484,730,133061
Netherlands,NLD,2001,8256,119860,424,552,3450,761,133303
Netherlands,NLD,2002,8311,120376,447,543,3444,753,133874
Netherlands,NLD,2003,8436,119228,452,503,3449,757,132825
Netherlands,NLD,2004,8067,117098,441,466,3226,719,130017
Netherlands,NLD,2005,8030,115840,436,473,3111,681,128571
Netherlands,NLD,2006,7757,115282,431,436,3000,638,127544
Netherlands,NLD,2007,7567,114365,428,405,2913,638,126316
Netherlands,NLD,2008,7472,114904,422,394,2901,650,126743
Netherlands,NLD,2009,7338,115176,411,390,2877,665,126857
Netherlands,NLD,2010,7100,116061,402,375,2891,649,127478
Netherlands,NLD,2011,6922,117190,387,354,2916,668,128437
Netherlands,NLD,2012,6796,119497,365,354,2962,694,130668
Netherlands,NLD,2013,6402,120616,338,349,2958,733,131396
Netherlands,NLD,2014,6105,121202,309,345,2932,956,131849
Netherlands,NLD,2015,6203,124634,293,322,2980,799,135231
Netherlands,NLD,2016,6290,127567,287,336,3017,828,138325
Netherlands,NLD,2017,6557,130122,310,327,3017,828,141161
Netherlands,NLD,2018,6762,132936,323,322,3017,828,144188
Netherlands,NLD,2019,7004,135907,336,315,3015,830,147407
New Zealand,NZL,1990,1123,22165,19,205,1364,154,25030
New Zealand,NZL,1991,1105,22246,19,191,1325,149,25035
New Zealand,NZL,1992,1087,22701,19,176,1314,153,25450
New Zealand,NZL,1993,1056,23107,20,181,1300,142,25806
New Zealand,NZL,1994,1018,23077,18,168,1272,150,25703
New Zealand,NZL,1995,957,23672,20,149,1303,152,26253
New Zealand,NZL,1996,935,23846,20,150,1289,155,26395
New Zealand,NZL,1997,846,23778,20,142,1274,155,26215
New Zealand,NZL,1998,696,23527,18,134,1230,147,25752
New Zealand,NZL,1999,674,24044,18,141,1195,141,26213
New Zealand,NZL,2000,609,23996,15,150,1144,155,26069
New Zealand,NZL,2001,604,24388,15,142,1136,153,26438
New Zealand,NZL,2002,607,24519,16,151,1126,170,26589
New Zealand,NZL,2003,595,24498,16,145,1118,167,26539
New Zealand,NZL,2004,606,24540,15,144,1112,162,26579
New Zealand,NZL,2005,601,24304,17,135,1082,175,26314
New Zealand,NZL,2006,627,24453,17,140,1066,174,26477
New Zealand,NZL,2007,652,24792,19,148,1071,176,26858
New Zealand,NZL,2008,672,25053,19,148,1070,182,27144
New Zealand,NZL,2009,706,25074,21,157,1042,194,27194
New Zealand,NZL,2010,750,25184,22,162,1013,184,27315
New Zealand,NZL,2011,811,25795,23,154,1175,185,28143
New Zealand,NZL,2012,854,26099,23,150,974,185,28285
New Zealand,NZL,2013,866,26163,23,146,937,183,28318
New Zealand,NZL,2014,920,26854,25,151,930,179,29059
New Zealand,NZL,2015,938,27223,25,129,934,186,29435
New Zealand,NZL,2016,942,27589,25,107,934,189,29786
New Zealand,NZL,2017,959,28109,27,112,928,191,30326
New Zealand,NZL,2018,1000,29606,27,109,936,194,31872
New Zealand,NZL,2019,1017,30367,27,107,939,195,32652
Nicaragua,NIC,1990,5025,7365,1035,2667,953,605,17650
Nicaragua,NIC,1991,4836,8281,981,2572,1036,654,18360
Nicaragua,NIC,1992,4588,8471,935,2456,1200,672,18322
Nicaragua,NIC,1993,4504,8915,909,2345,1074,669,18416
Nicaragua,NIC,1994,4114,9296,891,2223,1042,680,18246
Nicaragua,NIC,1995,3985,11417,888,2115,1110,673,20188
Nicaragua,NIC,1996,3637,11993,884,2027,1147,707,20395
Nicaragua,NIC,1997,3247,11741,852,1920,1060,675,19495
Nicaragua,NIC,1998,2988,11732,815,1818,5102,648,23103
Nicaragua,NIC,1999,2671,12097,769,1702,1072,656,18967
Nicaragua,NIC,2000,2481,12303,718,1615,1040,651,18808
Nicaragua,NIC,2001,2346,12988,690,1543,1052,664,19283
Nicaragua,NIC,2002,2269,13813,648,1479,1057,697,19963
Nicaragua,NIC,2003,2200,14494,605,1409,1071,740,20519
Nicaragua,NIC,2004,2151,15104,566,1359,1097,758,21035
Nicaragua,NIC,2005,2145,16020,530,1315,1121,799,21930
Nicaragua,NIC,2006,2044,15605,482,1253,1020,827,21231
Nicaragua,NIC,2007,2034,16725,447,1187,1271,809,22473
Nicaragua,NIC,2008,2000,17536,422,1127,1171,833,23089
Nicaragua,NIC,2009,1964,18024,412,1083,1156,840,23479
Nicaragua,NIC,2010,1915,18336,400,1041,1196,816,23704
Nicaragua,NIC,2011,1939,19140,376,998,1209,841,24503
Nicaragua,NIC,2012,1958,19808,352,956,1242,844,25160
Nicaragua,NIC,2013,1978,20451,334,931,1287,838,25819
Nicaragua,NIC,2014,1994,21123,320,894,1320,846,26497
Nicaragua,NIC,2015,1995,21398,305,856,1225,790,26569
Nicaragua,NIC,2016,2003,22402,308,822,1335,824,27694
Nicaragua,NIC,2017,1981,22895,302,778,1314,802,28072
Nicaragua,NIC,2018,1966,23628,296,723,1289,840,28742
Nicaragua,NIC,2019,1963,24137,288,683,1293,820,29184
Niger,NER,1990,94419,18703,10512,13474,3160,1402,141670
Niger,NER,1991,96140,18899,10551,14140,3196,1281,144207
Niger,NER,1992,98503,19413,10788,14912,3296,1333,148245
Niger,NER,1993,100743,19955,10974,15708,3392,1338,152110
Niger,NER,1994,101409,20236,10846,16095,3468,1446,153500
Niger,NER,1995,104635,20767,10896,16721,3485,1495,157999
Niger,NER,1996,102726,20823,10531,17216,3448,1448,156192
Niger,NER,1997,103018,21472,10569,18252,3551,1572,158434
Niger,NER,1998,103357,22123,10498,18964,3635,1776,160353
Niger,NER,1999,105113,22784,10602,19313,3755,1583,163150
Niger,NER,2000,106587,23575,10609,19539,3831,1612,165753
Niger,NER,2001,106450,24390,10287,19994,3925,1659,166705
Niger,NER,2002,103698,25143,9672,20072,3936,1685,164206
Niger,NER,2003,103502,26085,9157,20743,4010,1711,165208
Niger,NER,2004,98843,26347,8108,20745,3879,1702,159624
Niger,NER,2005,104979,27452,8350,21187,4160,1802,167930
Niger,NER,2006,102259,27910,7651,20702,4113,1819,164454
Niger,NER,2007,101627,28441,7128,20760,4113,1941,164010
Niger,NER,2008,97467,28660,6264,20144,3939,1850,158324
Niger,NER,2009,98529,29344,6013,20209,3997,1840,159932
Niger,NER,2010,97111,30117,5618,20641,3985,1852,159324
Niger,NER,2011,100080,31180,5667,21268,4169,1933,164297
Niger,NER,2012,101762,32319,5574,21930,4372,1976,167933
Niger,NER,2013,105011,33766,5685,22472,4587,2155,173676
Niger,NER,2014,103702,35221,5739,23141,4834,2281,174918
Niger,NER,2015,102300,37208,5681,23743,4997,2947,176876
Niger,NER,2016,100562,38935,5677,24462,5275,2792,177703
Niger,NER,2017,97948,40749,5508,25102,5430,2881,177618
Niger,NER,2018,91907,42103,5047,25675,5357,3198,173287
Niger,NER,2019,91590,43021,4820,26050,5356,3078,173915
Nigeria,NGA,2007,946856,354047,18205,212367,32650,16687,1580812
Nigeria,NGA,2008,937582,357363,17151,214596,32121,16930,1575743
Nigeria,NGA,2009,923366,364344,16773,217098,32548,18802,1572931
Nigeria,NGA,2013,815573,401852,14526,224258,33742,24359,1514310
Nigeria,NGA,2016,759547,418316,13201,220758,34702,24360,1470884
Nigeria,NGA,1990,714484,269399,20005,132906,21925,11163,1169882
Nigeria,NGA,1991,747657,274695,20556,137996,22528,11659,1215091
Nigeria,NGA,1992,753868,281392,20765,143440,23337,12763,1235565
Nigeria,NGA,1993,772318,287518,20903,149096,24074,13221,1267130
Nigeria,NGA,1994,794032,292683,21605,154483,24715,12447,1299965
Nigeria,NGA,1995,816822,296203,22275,158871,25148,12623,1331942
Nigeria,NGA,1996,853173,300576,22597,163484,25576,13023,1378429
Nigeria,NGA,1997,859163,306003,23264,168547,26215,14166,1397358
Nigeria,NGA,1998,881590,311740,23729,173679,26974,14672,1432384
Nigeria,NGA,1999,903690,317780,23820,178916,27828,17379,1469413
Nigeria,NGA,2000,921496,323382,23258,183302,28236,19548,1499222
Nigeria,NGA,2001,938120,327180,23350,188208,28936,17405,1523199
Nigeria,NGA,2002,944923,334651,22667,194134,29491,17234,1543100
Nigeria,NGA,2003,948221,338309,22196,198781,30086,16229,1553822
Nigeria,NGA,2004,940333,342720,20607,202454,30675,18496,1555285
Nigeria,NGA,2005,930200,345704,18756,205961,30959,15827,1547407
Nigeria,NGA,2006,946816,350964,18683,209405,31968,16456,1574292
Nigeria,NGA,2010,897096,372458,16217,219498,32844,18792,1556905
Nigeria,NGA,2011,862829,382004,15444,221740,33168,19384,1534569
Nigeria,NGA,2012,836537,393439,15332,223540,33920,20360,1523128
Nigeria,NGA,2014,801540,406068,13742,223127,33782,33174,1511433
Nigeria,NGA,2015,778476,413289,13492,221856,34114,33390,1494617
Nigeria,NGA,2017,738406,425984,12424,217279,34513,24672,1453278
Nigeria,NGA,2018,730325,432225,11293,214968,33975,25632,1448418
Nigeria,NGA,2019,720224,439983,10492,213047,33648,22106,1439500
Niue,NIU,1990,1,21,0,1,0,0,23
Niue,NIU,1991,1,21,0,0,0,0,22
Niue,NIU,1992,1,21,0,0,0,0,22
Niue,NIU,1993,1,21,0,0,0,0,22
Niue,NIU,1994,1,21,0,0,0,0,22
Niue,NIU,1995,1,21,0,0,0,0,22
Niue,NIU,1996,1,21,0,0,0,0,22
Niue,NIU,1997,1,21,0,0,0,0,22
Niue,NIU,1998,1,20,0,0,0,0,21
Niue,NIU,1999,1,19,0,0,0,0,20
Niue,NIU,2000,1,20,0,0,0,0,21
Niue,NIU,2001,1,20,0,0,0,0,21
Niue,NIU,2002,1,19,0,0,0,0,20
Niue,NIU,2003,1,19,0,0,0,0,20
Niue,NIU,2004,1,19,0,0,1,0,21
Niue,NIU,2005,1,17,0,0,0,0,18
Niue,NIU,2006,1,17,0,0,0,0,18
Niue,NIU,2007,1,17,0,0,0,0,18
Niue,NIU,2008,1,17,0,0,0,0,18
Niue,NIU,2009,1,17,0,0,0,0,18
Niue,NIU,2010,1,17,0,0,0,0,18
Niue,NIU,2011,1,17,0,0,0,0,18
Niue,NIU,2012,1,17,0,0,0,0,18
Niue,NIU,2013,1,17,0,0,0,0,18
Niue,NIU,2014,1,17,0,0,0,0,18
Niue,NIU,2015,1,17,0,0,0,0,18
Niue,NIU,2016,1,17,0,0,0,0,18
Niue,NIU,2017,1,17,0,0,0,0,18
Niue,NIU,2018,1,17,0,0,0,0,18
Niue,NIU,2019,1,17,0,0,0,0,18
North Korea,PRK,2008,12250,171241,873,5283,13271,2055,204973
North Korea,PRK,2010,11817,178774,832,4535,13446,2058,211462
North Korea,PRK,2011,11697,182213,820,4187,13427,2067,214411
North Korea,PRK,2012,11547,185147,809,3856,13557,2071,216987
North Korea,PRK,2013,11481,187643,797,3536,13393,2078,218928
North Korea,PRK,2014,11544,189999,790,3233,13199,2093,220858
North Korea,PRK,2015,11596,192306,784,2953,13174,2098,222911
North Korea,PRK,2016,11658,195114,785,2688,13666,2102,226013
North Korea,PRK,1990,18491,105819,3578,14604,12848,1881,157221
North Korea,PRK,1991,18033,109433,3176,14393,12610,1888,159533
North Korea,PRK,1992,17580,113204,2832,14103,12602,1896,162217
North Korea,PRK,1993,17173,117266,2562,13753,12575,1910,165239
North Korea,PRK,1994,16641,121515,2323,13270,12542,1928,168219
North Korea,PRK,1995,16013,124238,197264,12720,12684,1925,364844
North Korea,PRK,1996,15433,126343,148285,11975,12598,1939,316573
North Korea,PRK,1997,15074,129361,148139,11267,12490,1966,318297
North Korea,PRK,1998,14878,132187,148006,10578,12640,1992,320281
North Korea,PRK,1999,14595,135242,147873,9906,12572,2009,322197
North Korea,PRK,2000,14219,137935,147752,9289,12565,2008,323768
North Korea,PRK,2001,13747,140539,147631,8636,12692,1997,325242
North Korea,PRK,2002,13357,143122,147521,8045,12612,1992,326649
North Korea,PRK,2003,13106,146810,1061,7499,12724,1990,183190
North Korea,PRK,2004,12950,151798,993,7001,12825,2002,187569
North Korea,PRK,2005,12745,156600,940,6525,13061,1999,191870
North Korea,PRK,2006,12472,161692,903,6077,13177,2012,196333
North Korea,PRK,2007,12230,166611,871,5650,13687,2023,201072
North Korea,PRK,2009,12022,175304,850,4900,13322,2058,208456
North Korea,PRK,2017,11673,198345,791,2436,13027,2101,228373
North Korea,PRK,2018,11641,201368,797,2212,13265,2100,231383
North Korea,PRK,2019,11640,204395,807,2037,12993,2103,233975
North Macedonia,MKD,1990,699,14344,4,597,429,98,16171
North Macedonia,MKD,1991,652,14452,3,522,432,124,16185
North Macedonia,MKD,1992,647,15354,3,507,457,103,17071
North Macedonia,MKD,1993,592,15768,3,429,467,105,17364
North Macedonia,MKD,1994,559,15981,3,410,451,105,17509
North Macedonia,MKD,1995,514,16409,3,366,441,110,17843
North Macedonia,MKD,1996,454,16821,3,296,441,110,18125
North Macedonia,MKD,1997,419,17224,2,265,448,118,18476
North Macedonia,MKD,1998,411,17704,2,286,468,132,19003
North Macedonia,MKD,1999,374,17851,2,233,453,141,19054
North Macedonia,MKD,2000,348,18112,2,207,434,140,19243
North Macedonia,MKD,2001,331,18634,2,196,448,267,19878
North Macedonia,MKD,2002,318,19289,2,185,475,173,20442
North Macedonia,MKD,2003,305,19432,1,208,470,160,20576
North Macedonia,MKD,2004,282,19354,1,193,446,151,20427
North Macedonia,MKD,2005,267,19752,1,168,439,129,20756
North Macedonia,MKD,2006,265,20313,1,183,454,131,21347
North Macedonia,MKD,2007,257,20852,1,168,464,134,21876
North Macedonia,MKD,2008,241,20559,1,166,442,117,21526
North Macedonia,MKD,2009,235,20759,1,174,444,109,21722
North Macedonia,MKD,2010,226,20852,1,137,428,106,21750
North Macedonia,MKD,2011,219,20762,1,130,415,99,21626
North Macedonia,MKD,2012,225,21182,1,151,418,104,22081
North Macedonia,MKD,2013,223,21011,1,157,417,95,21904
North Macedonia,MKD,2014,227,21547,1,155,418,97,22445
North Macedonia,MKD,2015,229,22142,1,148,424,95,23039
North Macedonia,MKD,2016,236,22391,1,176,446,98,23348
North Macedonia,MKD,2017,233,22645,1,141,422,100,23542
North Macedonia,MKD,2018,234,22824,1,126,418,99,23702
North Macedonia,MKD,2019,234,23060,1,114,417,98,23924
Northern Mariana Islands,MNP,1990,11,129,2,6,23,5,176
Northern Mariana Islands,MNP,1991,11,137,2,6,24,6,186
Northern Mariana Islands,MNP,1992,11,137,2,6,24,6,186
Northern Mariana Islands,MNP,1993,11,136,2,5,22,5,181
Northern Mariana Islands,MNP,1994,11,136,2,5,22,5,181
Northern Mariana Islands,MNP,1995,11,141,2,5,23,5,187
Northern Mariana Islands,MNP,1996,11,146,2,5,24,6,194
Northern Mariana Islands,MNP,1997,13,157,2,6,27,6,211
Northern Mariana Islands,MNP,1998,14,169,2,8,30,7,230
Northern Mariana Islands,MNP,1999,15,179,2,8,30,7,241
Northern Mariana Islands,MNP,2000,15,192,2,8,33,7,257
Northern Mariana Islands,MNP,2001,15,198,2,7,33,7,262
Northern Mariana Islands,MNP,2002,14,199,2,6,32,7,260
Northern Mariana Islands,MNP,2003,14,202,2,5,30,7,260
Northern Mariana Islands,MNP,2004,12,203,2,5,32,8,262
Northern Mariana Islands,MNP,2005,12,211,2,4,28,8,265
Northern Mariana Islands,MNP,2006,13,217,2,4,26,6,268
Northern Mariana Islands,MNP,2007,13,225,2,4,25,8,277
Northern Mariana Islands,MNP,2008,13,232,2,4,23,6,280
Northern Mariana Islands,MNP,2009,13,241,2,4,23,6,289
Northern Mariana Islands,MNP,2010,13,247,2,3,22,5,292
Northern Mariana Islands,MNP,2011,13,255,2,3,21,5,299
Northern Mariana Islands,MNP,2012,14,257,2,3,19,5,300
Northern Mariana Islands,MNP,2013,14,261,2,3,19,5,304
Northern Mariana Islands,MNP,2014,14,268,2,3,18,5,310
Northern Mariana Islands,MNP,2015,14,277,2,3,18,5,319
Northern Mariana Islands,MNP,2016,14,287,2,3,18,5,329
Northern Mariana Islands,MNP,2017,14,294,2,3,18,5,336
Northern Mariana Islands,MNP,2018,14,299,2,2,19,5,341
Northern Mariana Islands,MNP,2019,15,303,2,2,17,5,344
Norway,NOR,1990,3198,37643,26,191,1408,493,42959
Norway,NOR,1991,3170,37358,25,177,1321,520,42571
Norway,NOR,1992,3209,37639,25,162,1291,524,42850
Norway,NOR,1993,3269,37999,24,146,1230,533,43201
Norway,NOR,1994,3137,37758,23,138,1199,548,42803
Norway,NOR,1995,3041,37500,24,125,1169,565,42424
Norway,NOR,1996,2827,37382,25,120,1134,579,42067
Norway,NOR,1997,2714,37330,26,116,1130,597,41913
Norway,NOR,1998,2668,37521,27,112,1132,617,42077
Norway,NOR,1999,2656,37424,27,115,1119,639,41980
Norway,NOR,2000,2637,37098,31,107,1108,677,41658
Norway,NOR,2001,2610,36812,35,102,1090,686,41335
Norway,NOR,2002,2601,36680,39,98,1065,687,41170
Norway,NOR,2003,2465,35782,43,98,1022,687,40097
Norway,NOR,2004,2369,35061,48,89,1005,683,39255
Norway,NOR,2005,2405,34573,57,89,989,664,38777
Norway,NOR,2006,2389,34651,64,90,966,666,38826
Norway,NOR,2007,2424,34934,71,87,952,649,39117
Norway,NOR,2008,2417,34756,79,84,971,642,38949
Norway,NOR,2009,2409,34460,88,86,972,642,38657
Norway,NOR,2010,2372,34234,102,79,964,637,38388
Norway,NOR,2011,2430,34724,131,71,966,702,39024
Norway,NOR,2012,2442,34577,156,71,919,611,38776
Norway,NOR,2013,2409,34415,173,68,922,609,38596
Norway,NOR,2014,2357,33795,186,67,905,589,37899
Norway,NOR,2015,2380,33623,201,64,880,568,37716
Norway,NOR,2016,2425,33826,213,60,876,564,37964
Norway,NOR,2017,2441,33531,219,57,856,547,37651
Norway,NOR,2018,2453,34156,202,55,864,556,38286
Norway,NOR,2019,2464,34517,194,54,870,564,38663
Oman,OMN,2009,559,7328,42,317,2189,70,10505
Oman,OMN,2015,656,8604,45,430,2339,85,12159
Oman,OMN,1990,717,5057,106,1001,1824,57,8762
Oman,OMN,1991,766,5180,97,942,1818,57,8860
Oman,OMN,1992,708,5309,87,855,1848,57,8864
Oman,OMN,1993,697,5407,82,788,1870,57,8901
Oman,OMN,1994,606,5541,77,730,1904,55,8913
Oman,OMN,1995,577,5685,74,671,1941,58,9006
Oman,OMN,1996,557,5844,69,612,1982,57,9121
Oman,OMN,1997,543,5969,64,555,2019,58,9208
Oman,OMN,1998,531,6044,63,504,2023,59,9224
Oman,OMN,1999,517,6088,59,457,1988,57,9166
Oman,OMN,2000,518,6170,56,413,1967,56,9180
Oman,OMN,2001,491,6214,53,377,1982,58,9175
Oman,OMN,2002,485,6349,50,343,2037,58,9322
Oman,OMN,2003,477,6363,49,312,2066,57,9324
Oman,OMN,2004,459,6218,45,283,1947,55,9007
Oman,OMN,2005,465,6394,45,257,1912,54,9127
Oman,OMN,2006,491,6780,46,256,2017,56,9646
Oman,OMN,2007,520,7057,45,265,2284,65,10236
Oman,OMN,2008,539,7235,44,288,2265,68,10439
Oman,OMN,2010,578,7580,42,333,2251,72,10856
Oman,OMN,2011,608,7947,43,359,2470,81,11508
Oman,OMN,2012,624,8176,44,386,2596,90,11916
Oman,OMN,2013,640,8318,44,406,2511,90,12009
Oman,OMN,2014,644,8351,43,415,2388,86,11927
Oman,OMN,2016,673,8840,46,447,2364,88,12458
Oman,OMN,2017,663,8865,44,414,2373,89,12448
Oman,OMN,2018,622,8459,41,382,2329,88,11921
Oman,OMN,2019,604,8366,40,354,2308,87,11759
Pakistan,PAK,2007,287508,628000,20009,299592,34541,19873,1289523
Pakistan,PAK,2008,292933,641751,22544,301779,35227,23263,1317497
Pakistan,PAK,2009,295031,653868,23570,301115,35829,26807,1336220
Pakistan,PAK,2012,285427,694171,24547,297087,37988,26474,1365694
Pakistan,PAK,2014,272530,731699,26210,296271,40352,24078,1391140
Pakistan,PAK,2015,270427,747855,26441,290522,41576,24167,1400988
Pakistan,PAK,2016,267859,765787,27318,287745,42384,20807,1411900
Pakistan,PAK,1990,333642,414598,29631,221539,23685,11827,1034922
Pakistan,PAK,1991,334789,428562,29304,228358,24569,12357,1057939
Pakistan,PAK,1992,338852,444135,28089,233526,26522,12113,1083237
Pakistan,PAK,1993,345823,459256,27906,236133,26467,12401,1107986
Pakistan,PAK,1994,350879,476685,26731,239789,27347,13293,1134724
Pakistan,PAK,1995,352117,497197,27698,246225,29488,14066,1166791
Pakistan,PAK,1996,349495,510370,27115,249611,29265,14143,1179999
Pakistan,PAK,1997,349136,523260,26297,253712,30083,14683,1197171
Pakistan,PAK,1998,345447,530645,25643,255465,31053,14612,1202865
Pakistan,PAK,1999,342206,541022,25209,262505,30589,15321,1216852
Pakistan,PAK,2000,331372,555208,24761,273254,30705,15234,1230534
Pakistan,PAK,2001,322799,568271,23860,281588,31553,15562,1243633
Pakistan,PAK,2002,318595,579590,23584,288927,32058,16131,1258885
Pakistan,PAK,2003,314843,590010,21883,294260,32826,16611,1270433
Pakistan,PAK,2004,307990,600064,21909,298493,32927,17044,1278427
Pakistan,PAK,2005,300423,610666,21090,299056,107251,16979,1355465
Pakistan,PAK,2006,295164,620257,20731,303560,34078,17573,1291363
Pakistan,PAK,2010,293887,666825,23430,301414,38297,30661,1354514
Pakistan,PAK,2011,292379,678982,23800,298571,37042,25072,1355846
Pakistan,PAK,2013,275023,713761,24906,297507,39537,25513,1376247
Pakistan,PAK,2017,264096,784005,27164,283073,42762,19759,1420859
Pakistan,PAK,2018,249800,800291,24486,270545,42791,20417,1408330
Pakistan,PAK,2019,242474,817376,23083,265947,43517,19497,1411894
Palau,PLW,1990,19,87,0,3,8,3,120
Palau,PLW,1991,19,90,0,3,8,3,123
Palau,PLW,1992,19,93,0,3,8,3,126
Palau,PLW,1993,19,96,0,3,9,3,130
Palau,PLW,1994,19,99,0,3,9,2,132
Palau,PLW,1995,20,103,0,4,9,3,139
Palau,PLW,1996,20,106,0,3,9,3,141
Palau,PLW,1997,20,110,0,3,9,3,145
Palau,PLW,1998,20,113,0,2,10,3,148
Palau,PLW,1999,19,117,0,2,10,3,151
Palau,PLW,2000,19,121,0,2,10,3,155
Palau,PLW,2001,19,123,0,2,10,4,158
Palau,PLW,2002,19,125,0,2,10,4,160
Palau,PLW,2003,19,127,0,2,10,4,162
Palau,PLW,2004,19,130,0,2,10,4,165
Palau,PLW,2005,20,132,0,2,10,4,168
Palau,PLW,2006,21,132,0,2,10,4,169
Palau,PLW,2007,20,134,0,2,10,3,169
Palau,PLW,2008,20,134,0,2,10,3,169
Palau,PLW,2009,20,135,0,2,10,3,170
Palau,PLW,2010,20,135,0,1,9,3,168
Palau,PLW,2011,20,138,0,1,9,2,170
Palau,PLW,2012,20,138,0,1,9,2,170
Palau,PLW,2013,20,142,0,1,9,2,174
Palau,PLW,2014,20,146,0,1,9,2,178
Palau,PLW,2015,20,151,0,1,9,2,183
Palau,PLW,2016,20,154,0,1,9,2,186
Palau,PLW,2017,21,157,0,1,9,2,190
Palau,PLW,2018,21,160,0,1,9,2,193
Palau,PLW,2019,23,167,0,1,9,2,202
Palestine,PSE,2009,613,9654,27,1712,493,6358,18857
Palestine,PSE,2010,590,9972,25,1629,473,918,13607
Palestine,PSE,2011,567,10270,25,1533,491,1026,13912
Palestine,PSE,2012,560,10220,25,1418,551,1456,14230
Palestine,PSE,2013,558,10468,23,1307,603,398,13357
Palestine,PSE,2014,574,11217,23,1210,574,523,14121
Palestine,PSE,2016,594,12191,23,1029,583,518,14938
Palestine,PSE,1990,718,6902,39,1880,490,533,10562
Palestine,PSE,1991,715,6973,37,1871,491,515,10602
Palestine,PSE,1992,707,7027,35,1847,488,565,10669
Palestine,PSE,1993,701,7098,33,1832,488,475,10627
Palestine,PSE,1994,693,7173,31,1800,486,295,10478
Palestine,PSE,1995,688,7273,31,1778,486,219,10475
Palestine,PSE,1996,688,7409,28,1767,490,194,10576
Palestine,PSE,1997,689,7526,26,1763,493,186,10683
Palestine,PSE,1998,686,7644,26,1753,494,222,10825
Palestine,PSE,1999,680,7763,26,1741,489,297,10996
Palestine,PSE,2000,679,7940,24,1755,491,2404,13293
Palestine,PSE,2001,681,8150,25,1780,500,3350,14486
Palestine,PSE,2002,683,8394,25,1809,510,4481,15902
Palestine,PSE,2003,680,8584,25,1829,512,3403,15033
Palestine,PSE,2004,676,8800,25,1842,511,3874,15728
Palestine,PSE,2005,676,8989,26,1850,525,2599,14665
Palestine,PSE,2006,664,9201,27,1840,525,5067,17324
Palestine,PSE,2007,642,9286,27,1822,518,2881,15176
Palestine,PSE,2008,633,9441,27,1781,506,6632,19020
Palestine,PSE,2015,587,11846,23,1124,584,567,14731
Palestine,PSE,2017,592,12518,23,926,572,474,15105
Palestine,PSE,2018,597,12896,23,875,580,510,15481
Palestine,PSE,2019,604,13346,23,832,604,389,15798
Panama,PAN,1990,1061,6433,221,571,813,259,9358
Panama,PAN,1991,1065,6532,233,560,858,275,9523
Panama,PAN,1992,1094,6902,250,552,841,292,9931
Panama,PAN,1993,1132,7326,272,549,890,325,10494
Panama,PAN,1994,1146,7384,292,547,899,363,10631
Panama,PAN,1995,1189,7675,315,553,930,387,11049
Panama,PAN,1996,1203,7724,327,556,904,334,11048
Panama,PAN,1997,1275,8215,364,549,924,368,11695
Panama,PAN,1998,1360,8395,387,537,931,349,11959
Panama,PAN,1999,1389,8415,413,521,923,350,12011
Panama,PAN,2000,1347,8309,420,499,840,358,11773
Panama,PAN,2001,1366,8593,409,481,834,380,12063
Panama,PAN,2002,1385,8977,384,457,841,427,12471
Panama,PAN,2003,1391,9472,357,448,875,433,12976
Panama,PAN,2004,1462,9710,335,435,857,414,13213
Panama,PAN,2005,1534,10070,320,446,844,456,13670
Panama,PAN,2006,1581,10382,304,445,897,501,14110
Panama,PAN,2007,1611,10439,279,444,883,582,14238
Panama,PAN,2008,1681,10839,263,434,936,706,14859
Panama,PAN,2009,1733,11258,249,426,902,839,15407
Panama,PAN,2010,1811,11611,238,440,879,825,15804
Panama,PAN,2011,1750,11968,234,463,889,823,16127
Panama,PAN,2012,1808,12456,240,477,906,819,16706
Panama,PAN,2013,1867,12941,245,480,867,783,17183
Panama,PAN,2014,1812,13344,241,468,906,763,17534
Panama,PAN,2015,1835,13641,242,450,854,688,17710
Panama,PAN,2016,1788,14057,243,450,862,645,18045
Panama,PAN,2017,1789,14512,244,436,872,669,18522
Panama,PAN,2018,1775,14808,244,425,877,687,18816
Panama,PAN,2019,1769,15232,245,413,878,687,19224
Papua New Guinea,PNG,1990,9371,13701,335,2713,1714,374,28208
Papua New Guinea,PNG,1991,9765,14175,340,2778,1969,365,29392
Papua New Guinea,PNG,1992,9853,14660,345,2838,1820,410,29926
Papua New Guinea,PNG,1993,9988,15032,346,2889,1907,387,30549
Papua New Guinea,PNG,1994,10128,15422,346,2938,1864,398,31096
Papua New Guinea,PNG,1995,10222,15899,350,3007,1890,407,31775
Papua New Guinea,PNG,1996,9983,16420,356,3098,1995,498,32350
Papua New Guinea,PNG,1997,10203,16985,391,3189,2038,411,33217
Papua New Guinea,PNG,1998,10693,17706,472,3342,4319,429,36961
Papua New Guinea,PNG,1999,11063,18390,393,3488,2226,513,36073
Papua New Guinea,PNG,2000,11807,18976,400,3597,2260,484,37524
Papua New Guinea,PNG,2001,12522,19611,406,3698,2317,554,39108
Papua New Guinea,PNG,2002,13147,20422,411,3811,2434,518,40743
Papua New Guinea,PNG,2003,13938,21225,413,3920,2451,525,42472
Papua New Guinea,PNG,2004,14843,22115,424,4024,2523,546,44475
Papua New Guinea,PNG,2005,15743,23077,447,4123,2670,572,46632
Papua New Guinea,PNG,2006,16557,23813,463,4214,2792,592,48431
Papua New Guinea,PNG,2007,16562,24660,471,4302,3039,624,49658
Papua New Guinea,PNG,2008,16809,25350,475,4378,2915,687,50614
Papua New Guinea,PNG,2009,17373,26002,472,4441,2928,754,51970
Papua New Guinea,PNG,2010,16955,27122,476,4526,3039,879,52997
Papua New Guinea,PNG,2011,16605,28060,468,4587,3107,1021,53848
Papua New Guinea,PNG,2012,16605,28930,463,4636,3213,1242,55089
Papua New Guinea,PNG,2013,16948,29635,456,4711,3178,1163,56091
Papua New Guinea,PNG,2014,16687,30544,443,4791,3232,1183,56880
Papua New Guinea,PNG,2015,16075,31726,474,4883,3318,1221,57697
Papua New Guinea,PNG,2016,16711,32536,417,4955,3374,1221,59214
Papua New Guinea,PNG,2017,16831,33783,410,5016,3461,1240,60741
Papua New Guinea,PNG,2018,16456,35196,408,5083,3738,1271,62152
Papua New Guinea,PNG,2019,16413,36406,407,5133,3627,1288,63274
Paraguay,PRY,1990,2199,9839,254,1899,795,415,15401
Paraguay,PRY,1991,2139,9693,242,1838,795,424,15131
Paraguay,PRY,1992,2216,10458,246,1847,880,455,16102
Paraguay,PRY,1993,2246,11022,242,1832,955,521,16818
Paraguay,PRY,1994,2258,11475,236,1791,1004,618,17382
Paraguay,PRY,1995,2319,12050,245,1810,1072,711,18207
Paraguay,PRY,1996,2378,12714,264,1808,1125,782,19071
Paraguay,PRY,1997,2326,12689,275,1782,1135,829,19036
Paraguay,PRY,1998,2310,13102,301,1761,1158,866,19498
Paraguay,PRY,1999,2304,13589,327,1750,1154,925,20049
Paraguay,PRY,2000,2286,13882,366,1753,1173,974,20434
Paraguay,PRY,2001,2253,14000,398,1708,1177,991,20527
Paraguay,PRY,2002,2254,14375,432,1651,1218,1013,20943
Paraguay,PRY,2003,2308,15164,466,1614,1334,1037,21923
Paraguay,PRY,2004,2380,16225,506,1589,1453,1048,23201
Paraguay,PRY,2005,2370,16695,515,1505,1482,1008,23575
Paraguay,PRY,2006,2356,17335,526,1438,1564,982,24201
Paraguay,PRY,2007,2281,17495,520,1345,1634,946,24221
Paraguay,PRY,2008,2284,18019,530,1279,1755,939,24806
Paraguay,PRY,2009,2349,19102,534,1208,1900,948,26041
Paraguay,PRY,2010,2410,19892,552,1124,1917,943,26838
Paraguay,PRY,2011,2472,20139,573,1052,1909,930,27075
Paraguay,PRY,2012,2497,20513,608,987,1917,954,27476
Paraguay,PRY,2013,2576,21449,644,935,1962,987,28553
Paraguay,PRY,2014,2563,21504,639,876,1963,1015,28560
Paraguay,PRY,2015,2558,22236,623,766,2031,1071,29285
Paraguay,PRY,2016,2644,23749,630,733,2139,1127,31022
Paraguay,PRY,2017,2635,24290,624,723,2138,1136,31546
Paraguay,PRY,2018,2571,24793,612,691,2149,1153,31969
Paraguay,PRY,2019,2534,25424,602,663,2186,1174,32583
Peru,PER,1990,37395,62148,6522,13714,6520,4426,130725
Peru,PER,1991,36612,59108,6316,13174,6019,4881,126110
Peru,PER,1992,35277,63772,6422,12999,6462,4289,129221
Peru,PER,1993,33580,65301,6156,12557,6687,3132,127413
Peru,PER,1994,31263,66540,5908,12023,6697,2821,125252
Peru,PER,1995,30128,68567,5856,11440,6701,2698,125390
Peru,PER,1996,28162,66931,5654,10747,6695,2516,120705
Peru,PER,1997,27276,68023,5421,10406,7338,2476,120940
Peru,PER,1998,26635,69274,5198,9945,7367,2288,120707
Peru,PER,1999,25147,67547,4974,9471,6938,2246,116323
Peru,PER,2000,24719,69520,4611,9479,6925,2078,117332
Peru,PER,2001,23343,68563,4114,8985,7024,2010,114039
Peru,PER,2002,22958,69866,3944,8613,6519,1953,113853
Peru,PER,2003,22898,72405,3858,8338,6442,2299,116240
Peru,PER,2004,22159,72198,3573,8051,6288,1985,114254
Peru,PER,2005,21865,73167,3361,7819,6254,1831,114297
Peru,PER,2006,21441,73696,3054,7395,6154,1762,113502
Peru,PER,2007,20841,73789,2799,6823,6662,1794,112708
Peru,PER,2008,21048,76927,2620,6582,6271,1705,115153
Peru,PER,2009,23042,87346,2709,6716,7134,2151,129098
Peru,PER,2010,23606,92041,2693,6766,7317,2213,134636
Peru,PER,2011,23476,93967,2528,6572,7130,1920,135593
Peru,PER,2012,23656,95672,2457,6370,7095,2115,137365
Peru,PER,2013,24045,97126,2389,6248,6918,1810,138536
Peru,PER,2014,23952,96951,2311,5938,6662,2297,138111
Peru,PER,2015,23844,97807,2255,5466,6533,1810,137715
Peru,PER,2016,24026,100260,2240,5309,6543,1808,140186
Peru,PER,2017,24083,103339,2321,4942,6817,1822,143324
Peru,PER,2018,24015,106395,2393,4676,6695,1843,146017
Peru,PER,2019,23937,109461,2471,4419,6813,1860,148961
Philippines,PHL,1990,100871,155215,10622,32346,21554,17487,338095
Philippines,PHL,1991,97386,156156,10053,32041,24641,17829,338106
Philippines,PHL,1992,97218,162865,9666,31900,17843,17151,336643
Philippines,PHL,1993,96619,169762,9369,32117,18163,16981,343011
Philippines,PHL,1994,95072,177168,9031,31892,17516,17457,348136
Philippines,PHL,1995,93063,184199,8794,31883,18569,17527,354035
Philippines,PHL,1996,91601,193649,8580,31705,17237,17705,360477
Philippines,PHL,1997,89390,200337,8284,31584,16917,17952,364464
Philippines,PHL,1998,88302,209599,8019,31547,17431,18123,373021
Philippines,PHL,1999,89132,217820,8131,31672,17035,18154,381944
Philippines,PHL,2000,88638,230383,8026,32323,17501,19998,396869
Philippines,PHL,2001,88499,243671,7983,33003,17634,19191,409981
Philippines,PHL,2002,88667,256548,7814,33340,17300,18478,422147
Philippines,PHL,2003,87861,262813,7461,33462,17094,18703,427394
Philippines,PHL,2004,86457,271039,6897,33227,18710,17698,434028
Philippines,PHL,2005,91672,285035,7236,33374,17382,17504,452203
Philippines,PHL,2006,95731,294569,7203,33188,21283,17193,469167
Philippines,PHL,2007,96199,301283,7037,32800,17907,16975,472201
Philippines,PHL,2008,97605,314621,7111,32517,19460,16972,488286
Philippines,PHL,2009,99671,326215,7055,32058,20950,17290,503239
Philippines,PHL,2010,98905,335471,6891,31368,19147,16520,508302
Philippines,PHL,2011,100071,346232,6906,31119,21671,16382,522381
Philippines,PHL,2012,101195,359351,7141,30577,22394,16267,536925
Philippines,PHL,2013,100895,370945,7197,30119,34162,16629,559947
Philippines,PHL,2014,102409,382812,7232,29480,20763,16373,559069
Philippines,PHL,2015,106437,398128,7334,28982,20875,17433,579189
Philippines,PHL,2016,106382,408548,7138,28592,21028,17659,589347
Philippines,PHL,2017,106224,417213,6978,28052,21459,19365,599291
Philippines,PHL,2018,104360,425505,6753,26497,21545,17728,602388
Philippines,PHL,2019,103447,435033,6622,25532,21318,17802,609754
Poland,POL,1990,9614,335892,75,4508,17818,5734,373641
Poland,POL,1991,9613,349179,85,4151,18967,6152,388147
Poland,POL,1992,9151,344050,93,3768,18509,6230,381801
Poland,POL,1993,8752,336006,98,3363,17554,6042,371815
Poland,POL,1994,8748,336159,107,3651,17841,6189,372695
Poland,POL,1995,8845,339952,116,3029,18166,6301,376409
Poland,POL,1996,8973,334874,125,2644,17612,6122,370350
Poland,POL,1997,9017,335460,138,2128,17968,6024,370735
Poland,POL,1998,9136,331078,155,1868,17891,5925,366053
Poland,POL,1999,9754,336004,184,1683,18132,5968,371725
Poland,POL,2000,9555,326169,182,1490,17114,5664,360174
Poland,POL,2001,9227,322740,182,1370,16765,5573,355857
Poland,POL,2002,9170,320202,182,1313,16512,5596,352975
Poland,POL,2003,9301,320687,174,1218,16232,5632,353244
Poland,POL,2004,9557,324542,180,1190,16389,5823,357681
Poland,POL,2005,9886,327128,179,1159,16339,6021,360712
Poland,POL,2006,10113,330934,180,1133,16278,6219,364857
Poland,POL,2007,10434,335675,184,1141,16296,6291,370021
Poland,POL,2008,10675,337184,188,1143,16063,6259,371512
Poland,POL,2009,10887,339475,193,1083,15570,6118,373326
Poland,POL,2010,10992,334464,188,968,14850,5980,367442
Poland,POL,2011,11341,335856,193,875,14469,6015,368749
Poland,POL,2012,11914,342693,205,837,14070,5955,375674
Poland,POL,2013,12378,343376,214,793,13376,5874,376011
Poland,POL,2014,12438,339920,215,747,12569,5721,371610
Poland,POL,2015,13186,350451,219,707,12443,5785,382791
Poland,POL,2016,13203,351001,237,707,12054,5822,383024
Poland,POL,2017,12924,356491,229,660,11962,5810,388076
Poland,POL,2018,12993,363877,227,610,11912,5808,395427
Poland,POL,2019,13014,369596,226,559,11769,5782,400946
Portugal,PRT,1990,4233,88356,217,672,5597,583,99658
Portugal,PRT,1991,4426,89775,219,630,5679,591,101320
Portugal,PRT,1992,4616,89207,204,543,5510,583,100663
Portugal,PRT,1993,4950,90465,205,482,5282,573,101957
Portugal,PRT,1994,5218,88244,200,420,4966,580,99628
Portugal,PRT,1995,5808,89602,205,388,4925,592,101520
Portugal,PRT,1996,6363,91097,202,368,4824,589,103443
Portugal,PRT,1997,6484,90627,207,356,4714,595,102983
Portugal,PRT,1998,6694,91213,214,341,4494,588,103544
Portugal,PRT,1999,7053,92039,217,320,4308,583,104520
Portugal,PRT,2000,6884,91148,214,316,4150,570,103282
Portugal,PRT,2001,6685,91183,200,294,4102,538,103002
Portugal,PRT,2002,6611,91960,223,291,4016,544,103645
Portugal,PRT,2003,6665,92438,232,251,3926,552,104064
Portugal,PRT,2004,6547,89849,218,233,3723,538,101108
Portugal,PRT,2005,6864,89386,208,221,3526,449,100654
Portugal,PRT,2006,7047,88541,213,200,3370,485,99856
Portugal,PRT,2007,7317,89310,221,195,3292,519,100854
Portugal,PRT,2008,7540,89525,221,191,3205,553,101235
Portugal,PRT,2009,7738,89899,224,193,3138,527,101719
Portugal,PRT,2010,7905,89923,229,165,3056,532,101810
Portugal,PRT,2011,8093,89774,231,166,2943,493,101700
Portugal,PRT,2012,8363,90259,238,161,2842,493,102356
Portugal,PRT,2013,8493,90401,247,147,2760,467,102515
Portugal,PRT,2014,8525,90497,250,141,2694,460,102567
Portugal,PRT,2015,8762,91413,261,145,2591,452,103624
Portugal,PRT,2016,8989,93677,274,149,2541,435,106065
Portugal,PRT,2017,9055,95873,280,126,2605,448,108387
Portugal,PRT,2018,9141,97674,285,114,2551,459,110224
Portugal,PRT,2019,9262,99823,291,103,2563,463,112505
Puerto Rico,PRI,1990,2382,19692,91,606,1236,1102,25109
Puerto Rico,PRI,1991,2539,20031,98,562,1240,1228,25698
Puerto Rico,PRI,1992,2717,20548,107,568,1276,1323,26539
Puerto Rico,PRI,1993,2769,21344,116,539,1301,1437,27506
Puerto Rico,PRI,1994,3175,21539,123,489,1233,1410,27969
Puerto Rico,PRI,1995,3215,22689,131,498,1277,1490,29300
Puerto Rico,PRI,1996,3049,23054,136,446,1238,1456,29379
Puerto Rico,PRI,1997,2405,22369,134,460,1172,1433,27973
Puerto Rico,PRI,1998,2261,23728,150,417,1193,1428,29177
Puerto Rico,PRI,1999,2201,22922,155,405,1097,1282,28062
Puerto Rico,PRI,2000,2099,22850,162,380,1070,1318,27879
Puerto Rico,PRI,2001,2205,23476,166,339,1067,1376,28629
Puerto Rico,PRI,2002,2021,22695,165,323,990,1295,27489
Puerto Rico,PRI,2003,1949,23116,165,309,960,1231,27730
Puerto Rico,PRI,2004,2007,23676,173,283,955,1201,28295
Puerto Rico,PRI,2005,2003,23782,176,288,950,1213,28412
Puerto Rico,PRI,2006,1894,23402,167,271,926,1185,27845
Puerto Rico,PRI,2007,1826,23751,173,258,910,1176,28094
Puerto Rico,PRI,2008,1819,23941,177,247,882,1169,28235
Puerto Rico,PRI,2009,1783,24563,184,232,889,1250,28901
Puerto Rico,PRI,2010,1652,23866,175,219,817,1221,27950
Puerto Rico,PRI,2011,1642,25350,186,220,843,1250,29491
Puerto Rico,PRI,2012,1510,24433,178,211,786,1160,28278
Puerto Rico,PRI,2013,1513,25318,186,169,780,1104,29070
Puerto Rico,PRI,2014,1499,25246,190,150,742,987,28814
Puerto Rico,PRI,2015,1394,24549,185,138,707,917,27890
Puerto Rico,PRI,2016,1495,25835,193,135,708,947,29313
Puerto Rico,PRI,2017,1541,26611,199,123,3072,923,32469
Puerto Rico,PRI,2018,1592,27513,205,117,718,903,31048
Puerto Rico,PRI,2019,1627,28074,210,113,718,900,31642
Qatar,QAT,1990,46,714,1,123,251,10,1145
Qatar,QAT,1991,45,755,1,119,259,10,1189
Qatar,QAT,1992,46,794,1,116,265,10,1232
Qatar,QAT,1993,45,825,1,112,267,10,1260
Qatar,QAT,1994,45,803,1,109,287,10,1255
Qatar,QAT,1995,46,810,1,109,312,13,1291
Qatar,QAT,1996,47,912,1,105,312,12,1389
Qatar,QAT,1997,48,988,1,100,315,11,1463
Qatar,QAT,1998,47,1032,1,97,317,12,1506
Qatar,QAT,1999,47,1056,1,92,319,12,1527
Qatar,QAT,2000,46,1064,1,89,324,12,1536
Qatar,QAT,2001,44,1097,1,87,341,14,1584
Qatar,QAT,2002,46,1177,1,86,368,13,1691
Qatar,QAT,2003,47,1241,1,85,380,14,1768
Qatar,QAT,2004,47,1278,1,86,406,15,1833
Qatar,QAT,2005,49,1363,1,88,456,20,1977
Qatar,QAT,2006,55,1486,1,90,521,21,2174
Qatar,QAT,2007,62,1599,1,93,576,26,2357
Qatar,QAT,2008,67,1681,1,95,642,29,2515
Qatar,QAT,2009,72,1778,1,99,715,34,2699
Qatar,QAT,2010,76,1855,1,102,768,37,2839
Qatar,QAT,2011,79,1921,1,102,799,41,2943
Qatar,QAT,2012,83,2004,1,102,841,43,3074
Qatar,QAT,2013,87,2110,2,102,853,45,3199
Qatar,QAT,2014,89,2225,2,101,858,49,3324
Qatar,QAT,2015,88,2305,2,100,853,46,3394
Qatar,QAT,2016,89,2406,2,95,874,45,3511
Qatar,QAT,2017,90,2539,2,92,882,46,3651
Qatar,QAT,2018,92,2739,1,89,904,49,3874
Qatar,QAT,2019,96,2954,1,87,941,52,4131
Romania,ROU,1990,12319,216694,74,1994,9392,4139,244612
Romania,ROU,1991,10929,220292,72,1734,9291,3949,246267
Romania,ROU,1992,11231,231968,77,1724,9592,4174,258766
Romania,ROU,1993,11661,234523,81,1726,9705,4210,261906
Romania,ROU,1994,12086,238297,91,1732,9997,4508,266711
Romania,ROU,1995,12210,248763,98,1525,10260,4562,277418
Romania,ROU,1996,12694,259555,101,1597,10403,4726,289076
Romania,ROU,1997,12611,259241,103,1651,10244,4645,288495
Romania,ROU,1998,11704,249852,99,1598,9475,4341,277069
Romania,ROU,1999,10744,238975,95,1458,8538,3888,263698
Romania,ROU,2000,10227,234140,96,1423,8130,3644,257660
Romania,ROU,2001,10016,240792,102,1314,8135,3556,263915
Romania,ROU,2002,9661,247400,103,1219,8119,3523,270025
Romania,ROU,2003,9160,247083,106,1256,7946,3316,268867
Romania,ROU,2004,8668,240772,102,1298,7671,2997,261508
Romania,ROU,2005,8266,242771,108,1222,7554,2786,262707
Romania,ROU,2006,7888,239536,106,1120,7394,2533,258577
Romania,ROU,2007,7530,236065,105,953,7264,2368,254285
Romania,ROU,2008,7553,239640,106,896,7357,2373,257925
Romania,ROU,2009,7509,243410,117,837,7240,2306,261419
Romania,ROU,2010,7421,244852,123,758,6970,2280,262404
Romania,ROU,2011,7104,236082,125,710,6298,1970,252289
Romania,ROU,2012,7237,239814,133,662,6159,2053,256058
Romania,ROU,2013,7086,233351,135,633,5742,1747,248694
Romania,ROU,2014,7516,242051,147,649,5838,1796,257997
Romania,ROU,2015,7663,242985,151,603,5726,1673,258801
Romania,ROU,2016,7825,244506,156,548,5634,1659,260328
Romania,ROU,2017,7852,247110,152,532,5611,1627,262884
Romania,ROU,2018,7696,249682,146,503,5515,1677,265219
Romania,ROU,2019,7602,252545,142,466,5494,1686,267935
Russia,RUS,1990,40201,1331899,704,16645,106513,82934,1578896
Russia,RUS,1991,40807,1355314,717,15399,110455,90116,1612808
Russia,RUS,1992,44983,1444573,778,13141,123131,110886,1737492
Russia,RUS,1993,57138,1685390,929,12864,150580,144177,2051078
Russia,RUS,1994,66826,1830323,1025,12526,166525,164922,2242147
Russia,RUS,1995,66304,1751452,984,11688,157924,162843,2151195
Russia,RUS,1996,62671,1663580,910,10466,142767,147689,2028083
Russia,RUS,1997,59220,1597056,847,10091,129609,132650,1929473
Russia,RUS,1998,58761,1586441,832,9509,127796,130224,1913563
Russia,RUS,1999,68725,1709486,913,9466,140736,149333,2078659
Russia,RUS,2000,76021,1776909,946,8999,148062,158661,2169598
Russia,RUS,2001,79641,1805179,944,8629,148583,161330,2204306
Russia,RUS,2002,84482,1857911,960,8119,149092,163643,2264207
Russia,RUS,2003,88414,1891115,973,8157,149984,162864,2301507
Russia,RUS,2004,87574,1849436,922,7513,145703,159753,2250901
Russia,RUS,2005,93131,1920252,942,7046,150493,158638,2330502
Russia,RUS,2006,84606,1796067,837,6991,134695,138730,2161926
Russia,RUS,2007,79988,1736481,760,7051,124351,125615,2074246
Russia,RUS,2008,79982,1756790,739,6852,120175,119091,2083629
Russia,RUS,2009,76279,1699625,683,6716,110220,107102,2000625
Russia,RUS,2010,76588,1721391,665,6058,108425,106438,2019565
Russia,RUS,2011,73288,1627946,607,6421,99046,91633,1898941
Russia,RUS,2012,71509,1605009,599,7455,95287,87151,1867010
Russia,RUS,2013,70556,1585788,602,6906,91288,83228,1838368
Russia,RUS,2014,71536,1614630,651,6447,90981,80989,1865234
Russia,RUS,2015,70470,1603733,690,5336,85216,77067,1842512
Russia,RUS,2016,69995,1592287,760,4747,79988,72878,1820655
Russia,RUS,2017,63117,1533940,745,3981,74114,68392,1744289
Russia,RUS,2018,62016,1540747,707,3970,74452,70625,1752517
Russia,RUS,2019,61259,1566357,702,3762,73592,71551,1777223
Rwanda,RWA,1990,54485,26862,6796,10628,3791,3519,106081
Rwanda,RWA,1991,57202,27991,7177,10573,3984,2003,108930
Rwanda,RWA,1992,57583,26661,7486,9266,3806,1921,106723
Rwanda,RWA,1993,54218,23401,7050,7250,3260,1653,96832
Rwanda,RWA,1994,59622,22355,6654,6632,3127,504182,602572
Rwanda,RWA,1995,53857,23458,6286,7583,3406,5036,99626
Rwanda,RWA,1996,58662,25512,6340,8548,3786,1201,104049
Rwanda,RWA,1997,62876,26399,6603,9079,3993,7142,116092
Rwanda,RWA,1998,64400,26036,6867,9210,4009,3374,113896
Rwanda,RWA,1999,63261,24975,6837,9012,3913,1095,109093
Rwanda,RWA,2000,61515,23886,6763,8887,3817,876,105744
Rwanda,RWA,2001,58880,22912,6478,8884,3714,2743,103611
Rwanda,RWA,2002,54989,22653,6239,9026,3780,707,97394
Rwanda,RWA,2003,50645,22412,5968,9138,3647,1208,93018
Rwanda,RWA,2004,46919,22374,6071,9193,3713,751,89021
Rwanda,RWA,2005,41551,22140,5695,9056,3654,752,82848
Rwanda,RWA,2006,36488,22042,5115,8735,3571,774,76725
Rwanda,RWA,2007,33343,22224,4680,8495,3514,781,73037
Rwanda,RWA,2008,31406,22469,4199,8418,3420,761,70673
Rwanda,RWA,2009,28542,22602,3500,8001,3222,2578,68445
Rwanda,RWA,2010,27426,23238,3324,7921,3257,970,66136
Rwanda,RWA,2011,25962,24007,3104,7698,3259,870,64900
Rwanda,RWA,2012,24388,24983,2952,7805,3278,867,64273
Rwanda,RWA,2013,22231,25669,2564,7092,3209,770,61535
Rwanda,RWA,2014,22325,26673,2647,6853,3314,788,62600
Rwanda,RWA,2015,22387,27709,2607,6815,3383,806,63707
Rwanda,RWA,2016,22625,28743,2491,6818,3540,969,65186
Rwanda,RWA,2017,22367,29830,2368,6720,3447,845,65577
Rwanda,RWA,2018,21278,31242,2331,6588,3619,868,65926
Rwanda,RWA,2019,20886,32497,2237,6474,3592,839,66525
Saint Kitts and Nevis,KNA,1990,36,379,14,18,16,11,474
Saint Kitts and Nevis,KNA,1991,33,326,13,17,16,11,416
Saint Kitts and Nevis,KNA,1992,33,324,12,16,15,11,411
Saint Kitts and Nevis,KNA,1993,33,318,11,16,16,11,405
Saint Kitts and Nevis,KNA,1994,34,326,11,15,16,11,413
Saint Kitts and Nevis,KNA,1995,35,337,11,15,16,10,424
Saint Kitts and Nevis,KNA,1996,36,332,11,14,16,10,419
Saint Kitts and Nevis,KNA,1997,37,326,10,14,15,12,414
Saint Kitts and Nevis,KNA,1998,37,321,9,13,20,11,411
Saint Kitts and Nevis,KNA,1999,40,314,9,12,13,12,400
Saint Kitts and Nevis,KNA,2000,39,309,9,11,13,11,392
Saint Kitts and Nevis,KNA,2001,39,303,8,11,13,12,386
Saint Kitts and Nevis,KNA,2002,40,300,8,11,13,11,383
Saint Kitts and Nevis,KNA,2003,40,295,7,10,12,13,377
Saint Kitts and Nevis,KNA,2004,40,292,7,10,12,13,374
Saint Kitts and Nevis,KNA,2005,40,292,7,9,12,13,373
Saint Kitts and Nevis,KNA,2006,41,296,7,9,12,12,377
Saint Kitts and Nevis,KNA,2007,41,297,7,9,12,15,381
Saint Kitts and Nevis,KNA,2008,42,286,7,9,13,18,375
Saint Kitts and Nevis,KNA,2009,41,287,7,9,13,21,378
Saint Kitts and Nevis,KNA,2010,42,289,7,8,13,21,380
Saint Kitts and Nevis,KNA,2011,43,294,6,8,13,23,387
Saint Kitts and Nevis,KNA,2012,45,298,6,8,14,21,392
Saint Kitts and Nevis,KNA,2013,46,305,6,8,14,22,401
Saint Kitts and Nevis,KNA,2014,48,313,7,8,14,22,412
Saint Kitts and Nevis,KNA,2015,49,319,7,8,14,23,420
Saint Kitts and Nevis,KNA,2016,50,328,7,8,13,23,429
Saint Kitts and Nevis,KNA,2017,52,337,7,7,14,23,440
Saint Kitts and Nevis,KNA,2018,54,349,7,7,14,23,454
Saint Kitts and Nevis,KNA,2019,57,379,7,7,12,21,483
Saint Lucia,LCA,1990,67,672,17,49,49,21,875
Saint Lucia,LCA,1991,64,678,17,48,50,21,878
Saint Lucia,LCA,1992,63,691,17,46,50,22,889
Saint Lucia,LCA,1993,65,694,15,43,50,24,891
Saint Lucia,LCA,1994,65,687,15,42,56,23,888
Saint Lucia,LCA,1995,62,688,14,40,52,22,878
Saint Lucia,LCA,1996,63,683,13,38,52,22,871
Saint Lucia,LCA,1997,59,673,13,38,51,22,856
Saint Lucia,LCA,1998,58,668,11,36,51,26,850
Saint Lucia,LCA,1999,60,672,11,35,48,25,851
Saint Lucia,LCA,2000,60,678,11,33,47,30,859
Saint Lucia,LCA,2001,62,698,11,33,49,30,883
Saint Lucia,LCA,2002,61,717,11,32,49,34,904
Saint Lucia,LCA,2003,62,732,10,32,48,35,919
Saint Lucia,LCA,2004,61,743,10,31,47,37,929
Saint Lucia,LCA,2005,60,747,10,30,46,37,930
Saint Lucia,LCA,2006,59,752,9,30,46,35,931
Saint Lucia,LCA,2007,58,746,9,29,49,34,925
Saint Lucia,LCA,2008,56,759,9,28,47,32,931
Saint Lucia,LCA,2009,55,770,9,27,46,40,947
Saint Lucia,LCA,2010,53,773,9,26,60,42,963
Saint Lucia,LCA,2011,54,791,8,25,47,43,968
Saint Lucia,LCA,2012,57,821,8,24,49,43,1002
Saint Lucia,LCA,2013,58,880,9,23,56,42,1068
Saint Lucia,LCA,2014,62,926,9,22,50,42,1111
Saint Lucia,LCA,2015,64,963,9,21,51,43,1151
Saint Lucia,LCA,2016,68,1058,11,20,51,41,1249
Saint Lucia,LCA,2017,70,1095,11,19,51,41,1287
Saint Lucia,LCA,2018,70,1128,11,19,51,42,1321
Saint Lucia,LCA,2019,71,1154,11,18,51,42,1347
Saint Vincent and the Grenadines,VCT,1990,66,516,25,44,32,18,701
Saint Vincent and the Grenadines,VCT,1991,61,524,23,43,33,19,703
Saint Vincent and the Grenadines,VCT,1992,62,537,23,41,33,19,715
Saint Vincent and the Grenadines,VCT,1993,64,544,21,40,31,19,719
Saint Vincent and the Grenadines,VCT,1994,65,546,21,39,32,19,722
Saint Vincent and the Grenadines,VCT,1995,66,533,19,39,32,23,712
Saint Vincent and the Grenadines,VCT,1996,72,535,19,36,32,20,714
Saint Vincent and the Grenadines,VCT,1997,70,535,17,35,32,20,709
Saint Vincent and the Grenadines,VCT,1998,70,541,17,34,32,22,716
Saint Vincent and the Grenadines,VCT,1999,74,545,16,33,32,19,719
Saint Vincent and the Grenadines,VCT,2000,81,550,16,31,31,20,729
Saint Vincent and the Grenadines,VCT,2001,74,539,15,30,31,19,708
Saint Vincent and the Grenadines,VCT,2002,76,545,15,29,37,21,723
Saint Vincent and the Grenadines,VCT,2003,69,548,14,28,29,20,708
Saint Vincent and the Grenadines,VCT,2004,70,554,13,27,27,26,717
Saint Vincent and the Grenadines,VCT,2005,66,556,13,26,31,28,720
Saint Vincent and the Grenadines,VCT,2006,66,559,13,25,29,27,719
Saint Vincent and the Grenadines,VCT,2007,64,568,13,24,27,30,726
Saint Vincent and the Grenadines,VCT,2008,61,600,13,23,28,28,753
Saint Vincent and the Grenadines,VCT,2009,61,626,13,22,27,29,778
Saint Vincent and the Grenadines,VCT,2010,63,648,13,21,26,27,798
Saint Vincent and the Grenadines,VCT,2011,62,677,12,20,25,27,823
Saint Vincent and the Grenadines,VCT,2012,62,701,12,19,25,27,846
Saint Vincent and the Grenadines,VCT,2013,64,724,13,18,40,31,890
Saint Vincent and the Grenadines,VCT,2014,71,752,13,17,27,30,910
Saint Vincent and the Grenadines,VCT,2015,74,766,14,16,27,30,927
Saint Vincent and the Grenadines,VCT,2016,68,779,15,16,28,33,939
Saint Vincent and the Grenadines,VCT,2017,68,795,15,15,28,31,952
Saint Vincent and the Grenadines,VCT,2018,68,812,15,14,28,31,968
Saint Vincent and the Grenadines,VCT,2019,67,826,15,14,28,31,981
Samoa,WSM,1990,107,748,10,46,73,14,998
Samoa,WSM,1991,104,761,10,44,79,14,1012
Samoa,WSM,1992,103,772,10,41,66,14,1006
Samoa,WSM,1993,102,782,10,39,67,14,1014
Samoa,WSM,1994,100,793,10,37,68,15,1023
Samoa,WSM,1995,100,806,10,35,68,15,1034
Samoa,WSM,1996,98,816,9,33,69,15,1040
Samoa,WSM,1997,95,825,8,32,69,16,1045
Samoa,WSM,1998,93,835,8,30,69,17,1052
Samoa,WSM,1999,94,851,8,30,69,17,1069
Samoa,WSM,2000,92,863,8,29,69,17,1078
Samoa,WSM,2001,92,878,8,27,68,17,1090
Samoa,WSM,2002,92,891,8,25,68,17,1101
Samoa,WSM,2003,92,906,8,25,68,16,1115
Samoa,WSM,2004,91,922,8,24,68,16,1129
Samoa,WSM,2005,92,938,8,24,76,16,1154
Samoa,WSM,2006,94,954,8,23,68,16,1163
Samoa,WSM,2007,94,964,8,22,67,16,1171
Samoa,WSM,2008,93,977,8,21,67,16,1182
Samoa,WSM,2009,95,988,8,21,215,16,1343
Samoa,WSM,2010,97,997,8,21,67,16,1206
Samoa,WSM,2011,97,1009,8,21,68,16,1219
Samoa,WSM,2012,100,1022,8,21,80,16,1247
Samoa,WSM,2013,100,1033,8,20,69,17,1247
Samoa,WSM,2014,103,1044,8,20,69,17,1261
Samoa,WSM,2015,102,1057,9,20,70,17,1275
Samoa,WSM,2016,103,1070,9,19,72,17,1290
Samoa,WSM,2017,104,1081,9,19,73,17,1303
Samoa,WSM,2018,104,1095,9,19,73,17,1317
Samoa,WSM,2019,103,1107,8,18,73,17,1326
San Marino,SMR,1990,4,146,0,1,6,0,157
San Marino,SMR,1991,4,150,0,1,6,0,161
San Marino,SMR,1992,4,153,0,1,6,0,164
San Marino,SMR,1993,4,156,0,1,6,0,167
San Marino,SMR,1994,4,162,0,1,6,0,173
San Marino,SMR,1995,5,164,0,1,6,0,176
San Marino,SMR,1996,5,167,0,1,6,0,179
San Marino,SMR,1997,5,170,0,1,6,0,182
San Marino,SMR,1998,6,173,0,1,6,0,186
San Marino,SMR,1999,6,179,0,1,6,0,192
San Marino,SMR,2000,6,185,0,1,6,0,198
San Marino,SMR,2001,6,190,0,1,6,0,203
San Marino,SMR,2002,6,196,0,1,6,0,209
San Marino,SMR,2003,6,203,0,1,6,0,216
San Marino,SMR,2004,7,212,0,1,6,0,226
San Marino,SMR,2005,7,219,0,1,6,0,233
San Marino,SMR,2006,7,223,0,1,6,0,237
San Marino,SMR,2007,7,226,0,1,7,0,241
San Marino,SMR,2008,7,232,0,1,7,0,247
San Marino,SMR,2009,7,235,0,1,7,0,250
San Marino,SMR,2010,7,239,0,1,7,0,254
San Marino,SMR,2011,8,244,0,1,7,0,260
San Marino,SMR,2012,8,247,0,1,7,0,263
San Marino,SMR,2013,8,253,0,1,7,0,269
San Marino,SMR,2014,8,258,0,1,7,0,274
San Marino,SMR,2015,8,264,0,1,7,0,280
San Marino,SMR,2016,8,267,0,1,7,0,283
San Marino,SMR,2017,9,274,0,1,7,0,291
San Marino,SMR,2018,9,276,0,1,7,0,293
San Marino,SMR,2019,9,280,0,1,7,0,297
Sao Tome and Principe,STP,1990,355,439,68,76,22,8,968
Sao Tome and Principe,STP,1991,348,449,66,77,22,9,971
Sao Tome and Principe,STP,1992,347,460,65,80,22,9,983
Sao Tome and Principe,STP,1993,346,469,63,82,22,9,991
Sao Tome and Principe,STP,1994,352,479,63,84,22,10,1010
Sao Tome and Principe,STP,1995,357,492,61,85,22,10,1027
Sao Tome and Principe,STP,1996,355,509,57,86,23,10,1040
Sao Tome and Principe,STP,1997,352,528,53,87,24,11,1055
Sao Tome and Principe,STP,1998,349,544,49,89,25,10,1066
Sao Tome and Principe,STP,1999,332,553,45,90,25,11,1056
Sao Tome and Principe,STP,2000,401,551,30,87,21,10,1100
Sao Tome and Principe,STP,2001,388,556,26,84,22,10,1086
Sao Tome and Principe,STP,2002,337,570,32,84,23,11,1057
Sao Tome and Principe,STP,2003,374,562,21,79,22,10,1068
Sao Tome and Principe,STP,2004,303,583,29,81,25,11,1032
Sao Tome and Principe,STP,2005,356,563,21,74,22,10,1046
Sao Tome and Principe,STP,2006,274,585,25,76,24,11,995
Sao Tome and Principe,STP,2007,232,593,25,78,25,12,965
Sao Tome and Principe,STP,2008,261,588,23,75,24,11,982
Sao Tome and Principe,STP,2009,244,597,21,73,24,11,970
Sao Tome and Principe,STP,2010,208,608,23,73,25,13,950
Sao Tome and Principe,STP,2011,230,601,18,68,23,12,952
Sao Tome and Principe,STP,2012,243,603,16,66,22,12,962
Sao Tome and Principe,STP,2013,222,617,16,66,25,13,959
Sao Tome and Principe,STP,2014,173,641,19,64,28,14,939
Sao Tome and Principe,STP,2015,169,649,18,61,28,14,939
Sao Tome and Principe,STP,2016,166,662,16,57,28,14,943
Sao Tome and Principe,STP,2017,165,674,16,54,28,15,952
Sao Tome and Principe,STP,2018,162,687,15,51,29,15,959
Sao Tome and Principe,STP,2019,160,697,14,48,29,15,963
Saudi Arabia,SAU,2007,6559,62861,147,3680,16286,616,90149
Saudi Arabia,SAU,2008,6802,64498,142,3356,17291,646,92735
Saudi Arabia,SAU,2009,6883,65607,136,3069,18385,676,94756
Saudi Arabia,SAU,2010,6993,66868,135,2809,19435,715,96955
Saudi Arabia,SAU,2011,6948,67317,132,2555,20319,735,98006
Saudi Arabia,SAU,2012,6905,68033,129,2331,21144,769,99311
Saudi Arabia,SAU,2013,6926,69571,127,2146,21548,810,101128
Saudi Arabia,SAU,2014,6962,71203,127,1980,22104,869,103245
Saudi Arabia,SAU,2015,6953,73316,125,1823,22544,1196,105957
Saudi Arabia,SAU,2016,7022,75265,125,1692,23059,1175,108338
Saudi Arabia,SAU,1990,7779,38315,463,10575,8933,425,66490
Saudi Arabia,SAU,1991,7439,39942,435,10358,9296,465,67935
Saudi Arabia,SAU,1992,7264,41404,404,10047,9529,446,69094
Saudi Arabia,SAU,1993,7110,42893,371,9666,9733,459,70232
Saudi Arabia,SAU,1994,6879,44500,342,9182,9945,469,71317
Saudi Arabia,SAU,1995,6755,46119,319,8784,10189,494,72660
Saudi Arabia,SAU,1996,6484,47594,295,8322,10363,504,73562
Saudi Arabia,SAU,1997,6331,48993,271,7871,11001,488,74955
Saudi Arabia,SAU,1998,6358,50387,250,7403,10769,497,75664
Saudi Arabia,SAU,1999,6195,51945,234,6944,11025,509,76852
Saudi Arabia,SAU,2000,6154,53395,219,6500,11187,520,77975
Saudi Arabia,SAU,2001,6021,54594,209,6082,11585,536,79027
Saudi Arabia,SAU,2002,5947,55774,201,5662,12095,558,80237
Saudi Arabia,SAU,2003,6026,57117,187,5234,12736,645,81945
Saudi Arabia,SAU,2004,6049,58119,170,4801,13143,700,82982
Saudi Arabia,SAU,2005,6195,59718,159,4400,14302,595,85369
Saudi Arabia,SAU,2006,6323,61217,152,4037,15181,599,87509
Saudi Arabia,SAU,2017,7088,77561,125,1538,23593,926,110831
Saudi Arabia,SAU,2018,7160,80297,125,1413,24093,956,114044
Saudi Arabia,SAU,2019,7259,83434,127,1322,24556,965,117663
Senegal,SEN,1990,38367,20203,3065,11230,2407,521,75793
Senegal,SEN,1991,38423,20634,3033,11353,2439,443,76325
Senegal,SEN,1992,39266,20874,2966,11478,2444,619,77647
Senegal,SEN,1993,40047,21162,2893,11660,2445,702,78909
Senegal,SEN,1994,41303,21668,2839,11827,2498,428,80563
Senegal,SEN,1995,43228,21579,2671,11898,2440,758,82574
Senegal,SEN,1996,44472,21599,2507,11885,2393,409,83265
Senegal,SEN,1997,45749,21784,2317,11807,2367,837,84861
Senegal,SEN,1998,46403,22280,2203,11765,2405,783,85839
Senegal,SEN,1999,46730,22817,2097,11657,2639,445,86385
Senegal,SEN,2000,47141,22841,1905,11539,2350,471,86247
Senegal,SEN,2001,39166,26932,2276,12131,2954,570,84029
Senegal,SEN,2002,37997,27603,2117,12267,2995,578,83557
Senegal,SEN,2003,39210,26896,1806,12289,2799,505,83505
Senegal,SEN,2004,39121,28315,1912,12605,3012,505,85470
Senegal,SEN,2005,38459,28976,1792,12780,3040,553,85600
Senegal,SEN,2006,37799,29367,1640,12785,2993,626,85210
Senegal,SEN,2007,36005,30074,1558,12840,3047,511,84035
Senegal,SEN,2008,33791,31036,1484,12868,3092,529,82800
Senegal,SEN,2009,31042,32544,1418,12869,3200,561,81634
Senegal,SEN,2010,34171,31474,1187,12477,2927,510,82746
Senegal,SEN,2011,32922,32707,1137,12392,3002,551,82711
Senegal,SEN,2012,32532,33082,1023,12268,2986,517,82408
Senegal,SEN,2013,31047,34230,1002,12306,3087,524,82196
Senegal,SEN,2014,30375,35934,1091,12346,3317,571,83634
Senegal,SEN,2015,30123,37042,1062,12263,3289,566,84345
Senegal,SEN,2016,28928,38451,1054,12167,3430,606,84636
Senegal,SEN,2017,28967,38937,991,12046,3444,587,84972
Senegal,SEN,2018,28386,39142,881,11499,3453,595,83956
Senegal,SEN,2019,27198,40320,821,11155,3484,581,83559
Serbia,SRB,1990,1881,86031,26,1995,3976,1045,94954
Serbia,SRB,1991,1749,86284,23,1587,3942,4339,97924
Serbia,SRB,1992,1779,88855,23,1585,4055,1414,97711
Serbia,SRB,1993,1818,92106,24,1572,4113,1095,100728
Serbia,SRB,1994,1898,95124,26,1753,4258,1133,104192
Serbia,SRB,1995,1898,98548,24,1573,4347,1153,107543
Serbia,SRB,1996,1902,102388,23,1409,4419,1172,111313
Serbia,SRB,1997,1913,106738,23,1221,4472,1176,115543
Serbia,SRB,1998,1716,99556,20,1036,3970,2571,108869
Serbia,SRB,1999,1635,100234,18,826,3961,10495,117169
Serbia,SRB,2000,1633,103161,20,832,4071,1624,111341
Serbia,SRB,2001,1569,102417,20,886,3865,1174,109931
Serbia,SRB,2002,1536,102917,20,886,3729,1097,110185
Serbia,SRB,2003,1551,105991,22,901,3687,1052,113204
Serbia,SRB,2004,1534,108886,24,789,3620,1060,115913
Serbia,SRB,2005,1536,112882,26,655,3585,1007,119691
Serbia,SRB,2006,1504,112952,27,554,3450,960,119447
Serbia,SRB,2007,1493,112771,28,456,3327,940,119015
Serbia,SRB,2008,1517,114436,28,305,3284,923,120493
Serbia,SRB,2009,1562,113578,29,355,3171,889,119584
Serbia,SRB,2010,1586,110968,30,341,2996,855,116776
Serbia,SRB,2011,1643,109053,31,370,2896,819,114812
Serbia,SRB,2012,1698,108745,31,214,2796,826,114310
Serbia,SRB,2013,1791,109236,33,316,2698,776,114850
Serbia,SRB,2014,1856,110235,33,282,2702,767,115875
Serbia,SRB,2015,1886,110315,33,255,2616,756,115861
Serbia,SRB,2016,1837,107558,32,243,2480,732,112882
Serbia,SRB,2017,1835,108619,31,214,2468,738,113905
Serbia,SRB,2018,1838,110554,31,196,2476,742,115837
Serbia,SRB,2019,1819,111358,31,179,2467,736,116590
Seychelles,SYC,1990,70,411,6,19,26,5,537
Seychelles,SYC,1991,71,416,5,18,27,5,542
Seychelles,SYC,1992,70,424,5,17,27,5,548
Seychelles,SYC,1993,74,431,5,15,29,5,559
Seychelles,SYC,1994,72,443,5,14,31,7,572
Seychelles,SYC,1995,64,449,5,13,33,7,571
Seychelles,SYC,1996,65,456,4,12,33,8,578
Seychelles,SYC,1997,63,458,4,12,38,8,583
Seychelles,SYC,1998,63,461,4,11,33,8,580
Seychelles,SYC,1999,61,461,4,11,33,9,579
Seychelles,SYC,2000,60,460,4,11,33,9,577
Seychelles,SYC,2001,61,464,4,12,33,9,583
Seychelles,SYC,2002,63,482,4,12,34,9,604
Seychelles,SYC,2003,66,498,4,12,35,9,624
Seychelles,SYC,2004,67,502,4,12,38,9,632
Seychelles,SYC,2005,70,514,4,11,34,8,641
Seychelles,SYC,2006,71,518,4,11,34,8,646
Seychelles,SYC,2007,74,519,4,11,34,8,650
Seychelles,SYC,2008,75,528,4,11,32,7,657
Seychelles,SYC,2009,78,532,4,11,32,7,664
Seychelles,SYC,2010,79,525,4,11,34,8,661
Seychelles,SYC,2011,80,521,4,11,36,8,660
Seychelles,SYC,2012,84,537,4,11,34,7,677
Seychelles,SYC,2013,87,545,4,11,36,7,690
Seychelles,SYC,2014,89,552,4,10,36,7,698
Seychelles,SYC,2015,92,567,4,10,38,8,719
Seychelles,SYC,2016,93,586,4,10,38,8,739
Seychelles,SYC,2017,94,602,4,9,39,8,756
Seychelles,SYC,2018,93,617,4,9,39,8,770
Seychelles,SYC,2019,92,632,4,9,39,8,784
Sierra Leone,SLE,1990,31890,12748,4550,8071,1580,240,59079
Sierra Leone,SLE,1991,31320,12580,4560,7753,1548,1589,59350
Sierra Leone,SLE,1992,30765,12563,4502,7751,1535,790,57906
Sierra Leone,SLE,1993,30685,12505,4448,7858,1517,881,57894
Sierra Leone,SLE,1994,31407,12467,4383,7857,1490,2562,60166
Sierra Leone,SLE,1995,31515,12599,4341,7911,1493,3474,61333
Sierra Leone,SLE,1996,31505,12688,4328,7895,1508,1246,59170
Sierra Leone,SLE,1997,32245,12860,4336,7764,1513,1493,60211
Sierra Leone,SLE,1998,32593,12961,4363,7874,1536,5412,64739
Sierra Leone,SLE,1999,33734,13123,4417,8237,1578,4810,65899
Sierra Leone,SLE,2000,35162,13426,4540,8667,1622,1431,64848
Sierra Leone,SLE,2001,36785,13753,4585,9038,1695,374,66230
Sierra Leone,SLE,2002,38112,14218,4615,9231,1778,298,68252
Sierra Leone,SLE,2003,38876,14619,4604,9331,1864,313,69607
Sierra Leone,SLE,2004,40072,15092,4754,9377,2000,327,71622
Sierra Leone,SLE,2005,39913,15555,4713,9389,2097,339,72006
Sierra Leone,SLE,2006,39916,15810,4574,9332,2123,347,72102
Sierra Leone,SLE,2007,39620,16055,4322,9276,2169,363,71805
Sierra Leone,SLE,2008,39860,16069,3911,9132,2131,360,71463
Sierra Leone,SLE,2009,38736,16321,3620,9062,2250,357,70346
Sierra Leone,SLE,2010,37780,16788,3520,9040,2244,372,69744
Sierra Leone,SLE,2011,36342,17092,3389,8977,2251,378,68429
Sierra Leone,SLE,2012,35560,17505,3215,8825,2289,388,67782
Sierra Leone,SLE,2013,34400,17814,3065,8639,2349,398,66665
Sierra Leone,SLE,2014,33255,18077,2925,8472,2386,406,65521
Sierra Leone,SLE,2015,32972,18581,2746,8344,2368,404,65415
Sierra Leone,SLE,2016,32587,18930,2615,8273,2393,414,65212
Sierra Leone,SLE,2017,31730,19536,2530,8213,3802,421,66232
Sierra Leone,SLE,2018,30610,20155,2432,8187,2503,433,64320
Sierra Leone,SLE,2019,30002,20557,2323,8155,2532,435,64004
Singapore,SGP,2007,2204,12763,2,43,700,58,15770
Singapore,SGP,2008,2279,13168,2,44,729,62,16284
Singapore,SGP,2009,2357,13316,2,43,725,56,16499
Singapore,SGP,2014,2957,15158,2,38,686,53,18894
Singapore,SGP,2015,3055,15549,2,37,677,54,19374
Singapore,SGP,2016,3168,15985,2,37,670,57,19919
Singapore,SGP,1990,1496,11070,6,132,776,81,13561
Singapore,SGP,1991,1504,11075,5,111,776,92,13563
Singapore,SGP,1992,1536,11111,3,103,780,84,13617
Singapore,SGP,1993,1607,11242,2,97,771,88,13807
Singapore,SGP,1994,1692,11584,1,91,781,84,14233
Singapore,SGP,1995,1783,11843,1,85,789,83,14584
Singapore,SGP,1996,1802,12067,1,85,800,80,14835
Singapore,SGP,1997,1774,12101,1,78,808,94,14856
Singapore,SGP,1998,1807,12205,1,72,799,86,14970
Singapore,SGP,1999,1772,12083,1,67,754,89,14766
Singapore,SGP,2000,1782,11976,1,61,752,85,14657
Singapore,SGP,2001,1802,12019,1,49,743,74,14688
Singapore,SGP,2002,1912,12097,1,47,733,70,14860
Singapore,SGP,2003,1994,12130,1,41,700,70,14936
Singapore,SGP,2004,2057,12303,1,39,688,60,15148
Singapore,SGP,2005,2057,12101,1,41,666,56,14922
Singapore,SGP,2006,2107,12361,1,43,680,54,15246
Singapore,SGP,2010,2451,13628,2,42,708,60,16891
Singapore,SGP,2011,2527,13910,2,46,702,56,17243
Singapore,SGP,2012,2684,14429,2,44,714,51,17924
Singapore,SGP,2013,2827,14768,2,39,700,51,18387
Singapore,SGP,2017,3293,16413,3,34,646,58,20447
Singapore,SGP,2018,3463,17263,3,33,651,57,21470
Singapore,SGP,2019,3607,18057,3,32,662,59,22420
Slovakia,SVK,1990,2971,47718,13,523,2282,602,54109
Slovakia,SVK,1991,2944,47181,13,535,2238,590,53501
Slovakia,SVK,1992,2864,46465,13,486,2178,579,52585
Slovakia,SVK,1993,2751,45774,13,414,2050,551,51553
Slovakia,SVK,1994,2615,45011,13,371,1966,520,50496
Slovakia,SVK,1995,2570,46047,13,342,1969,513,51454
Slovakia,SVK,1996,2383,45226,12,312,1902,491,50326
Slovakia,SVK,1997,2315,47030,11,273,1999,512,52140
Slovakia,SVK,1998,2154,47499,10,261,2103,512,52539
Slovakia,SVK,1999,2025,47623,10,241,2002,505,52406
Slovakia,SVK,2000,1917,47111,8,222,1953,501,51712
Slovakia,SVK,2001,1888,47558,8,179,1927,504,52064
Slovakia,SVK,2002,1874,47375,8,185,1935,517,51894
Slovakia,SVK,2003,1905,47744,7,197,1926,526,52305
Slovakia,SVK,2004,1904,47579,8,191,1848,523,52053
Slovakia,SVK,2005,1974,48934,8,185,1867,545,53513
Slovakia,SVK,2006,1976,48958,8,172,1814,551,53479
Slovakia,SVK,2007,2023,49934,9,166,1833,570,54535
Slovakia,SVK,2008,1989,49175,10,168,1780,567,53689
Slovakia,SVK,2009,1958,49275,12,175,1686,564,53670
Slovakia,SVK,2010,1918,48270,12,167,1585,612,52564
Slovakia,SVK,2011,1925,48534,14,151,1539,619,52782
Slovakia,SVK,2012,1905,48060,17,149,1477,564,52172
Slovakia,SVK,2013,1880,47700,19,145,1404,549,51697
Slovakia,SVK,2014,1865,47518,20,151,1394,549,51497
Slovakia,SVK,2015,1925,49129,20,148,1421,549,53192
Slovakia,SVK,2016,1877,48290,18,146,1331,515,52177
Slovakia,SVK,2017,1898,49094,18,137,1318,505,52970
Slovakia,SVK,2018,1906,49645,18,128,1318,496,53511
Slovakia,SVK,2019,1925,50439,18,117,1311,489,54299
Slovenia,SVN,1990,597,16315,7,93,1190,201,18403
Slovenia,SVN,1991,578,16298,7,85,1166,224,18358
Slovenia,SVN,1992,578,16218,6,77,1146,199,18224
Slovenia,SVN,1993,598,16237,6,66,1136,189,18232
Slovenia,SVN,1994,624,16267,6,59,1134,202,18292
Slovenia,SVN,1995,675,16344,6,51,1116,214,18406
Slovenia,SVN,1996,702,16481,6,48,1117,217,18571
Slovenia,SVN,1997,751,16576,5,46,1109,235,18722
Slovenia,SVN,1998,770,16721,5,44,1097,227,18864
Slovenia,SVN,1999,760,16692,5,44,1063,231,18795
Slovenia,SVN,2000,738,16449,5,42,1025,228,18487
Slovenia,SVN,2001,732,16845,5,40,1035,230,18887
Slovenia,SVN,2002,716,16492,5,37,982,230,18462
Slovenia,SVN,2003,713,16585,4,36,982,233,18553
Slovenia,SVN,2004,702,16569,3,38,928,230,18470
Slovenia,SVN,2005,665,16179,3,38,860,212,17957
Slovenia,SVN,2006,637,16280,2,36,867,212,18034
Slovenia,SVN,2007,611,16449,3,34,834,217,18148
Slovenia,SVN,2008,596,16308,2,33,766,220,17925
Slovenia,SVN,2009,593,16407,2,32,717,226,17977
Slovenia,SVN,2010,590,16601,2,32,688,234,18147
Slovenia,SVN,2011,605,16660,2,31,651,247,18196
Slovenia,SVN,2012,623,16977,2,27,649,258,18536
Slovenia,SVN,2013,626,16886,1,28,630,268,18439
Slovenia,SVN,2014,595,16285,1,25,574,272,17752
Slovenia,SVN,2015,630,17119,1,23,606,283,18662
Slovenia,SVN,2016,649,17230,2,22,589,276,18768
Slovenia,SVN,2017,677,17761,3,19,590,277,19327
Slovenia,SVN,2018,700,18213,3,18,585,276,19795
Slovenia,SVN,2019,721,18626,3,16,577,276,20219
Solomon Islands,SLB,1990,911,1792,71,187,227,43,3231
Solomon Islands,SLB,1991,924,1863,72,193,235,45,3332
Solomon Islands,SLB,1992,937,1927,71,197,244,45,3421
Solomon Islands,SLB,1993,947,1990,70,201,256,47,3511
Solomon Islands,SLB,1994,955,2058,70,205,261,48,3597
Solomon Islands,SLB,1995,963,2124,68,208,268,50,3681
Solomon Islands,SLB,1996,969,2197,68,211,276,52,3773
Solomon Islands,SLB,1997,975,2280,68,215,285,53,3876
Solomon Islands,SLB,1998,1007,2366,75,219,299,55,4021
Solomon Islands,SLB,1999,1032,2446,78,224,309,60,4149
Solomon Islands,SLB,2000,1041,2540,78,228,320,61,4268
Solomon Islands,SLB,2001,1051,2639,77,232,329,63,4391
Solomon Islands,SLB,2002,1088,2716,76,235,338,68,4521
Solomon Islands,SLB,2003,1099,2803,71,237,345,69,4624
Solomon Islands,SLB,2004,1110,2882,66,238,350,70,4716
Solomon Islands,SLB,2005,1131,2968,66,238,357,73,4833
Solomon Islands,SLB,2006,1137,3053,65,235,365,74,4929
Solomon Islands,SLB,2007,1183,3105,67,229,425,74,5083
Solomon Islands,SLB,2008,1331,3060,66,219,368,71,5115
Solomon Islands,SLB,2009,1251,3195,64,213,403,72,5198
Solomon Islands,SLB,2010,1271,3247,64,209,390,70,5251
Solomon Islands,SLB,2011,1140,3405,62,206,401,70,5284
Solomon Islands,SLB,2012,1080,3505,58,202,406,68,5319
Solomon Islands,SLB,2013,1048,3601,58,197,423,67,5394
Solomon Islands,SLB,2014,998,3712,56,192,468,68,5494
Solomon Islands,SLB,2015,991,3797,58,188,438,67,5539
Solomon Islands,SLB,2016,1023,3843,56,183,433,64,5602
Solomon Islands,SLB,2017,990,3942,54,176,437,69,5668
Solomon Islands,SLB,2018,924,4080,53,172,438,76,5743
Solomon Islands,SLB,2019,916,4169,51,171,442,76,5825
Somalia,SOM,2007,66651,31452,16367,18380,4679,4686,142215
Somalia,SOM,2009,66525,33836,17372,19291,5099,5156,147279
Somalia,SOM,2010,66572,34763,37020,19521,5245,6369,169490
Somalia,SOM,2011,67077,35630,36646,19806,5325,5399,169883
Somalia,SOM,2012,66571,36570,16587,20132,5455,6696,152011
Somalia,SOM,2013,67162,37609,16210,20519,5722,4895,152117
Somalia,SOM,2014,67365,38790,15759,20929,5673,4738,153254
Somalia,SOM,2015,67102,40047,15170,21338,5786,4773,154216
Somalia,SOM,2016,68361,41393,15149,21806,6001,5826,158536
Somalia,SOM,1990,43831,20213,15295,11135,2706,3602,96782
Somalia,SOM,1991,43609,20332,14568,10967,2684,9374,101534
Somalia,SOM,1992,45730,20741,14350,11333,2787,5725,100666
Somalia,SOM,1993,48641,21078,14384,11673,2906,1557,100239
Somalia,SOM,1994,52592,21548,14436,12021,3163,1869,105629
Somalia,SOM,1995,54284,22151,14689,12445,3196,1740,108505
Somalia,SOM,1996,56259,22805,15035,12867,3322,2346,112634
Somalia,SOM,1997,58535,23534,15218,13406,5781,2283,118757
Somalia,SOM,1998,60674,24283,15448,14019,3614,2156,120194
Somalia,SOM,1999,62326,24861,15583,14588,3724,2315,123397
Somalia,SOM,2000,64254,25408,15512,15118,3812,2041,126145
Somalia,SOM,2001,64825,25949,15461,15614,3889,2462,128200
Somalia,SOM,2002,64731,26854,15534,16185,4027,2693,130024
Somalia,SOM,2003,64583,27805,15663,16685,4139,2973,131848
Somalia,SOM,2004,64153,28726,15699,17108,4543,4136,134365
Somalia,SOM,2005,63993,29526,15636,17494,4339,2813,133801
Somalia,SOM,2006,64042,30147,15539,17623,4500,3490,135341
Somalia,SOM,2008,66896,32753,17354,18900,4937,4931,145771
Somalia,SOM,2017,67656,42671,14486,22105,6080,7997,160995
Somalia,SOM,2018,68706,44194,14750,22559,6180,7189,163578
Somalia,SOM,2019,70416,45459,15102,22771,6302,5297,165347
South Africa,ZAF,1990,76260,113057,10723,22657,30440,24501,277638
South Africa,ZAF,1991,77541,117811,10255,22358,31031,24722,283718
South Africa,ZAF,1992,82857,128141,9980,22575,33230,26282,303065
South Africa,ZAF,1993,85124,128070,9255,22011,30943,25335,300738
South Africa,ZAF,1994,95484,139549,8843,22017,31945,25968,323806
South Africa,ZAF,1995,108267,144986,8179,21858,32177,25748,341215
South Africa,ZAF,1996,127781,159537,7581,21997,31598,25448,373942
South Africa,ZAF,1997,157144,183553,7329,22830,35778,27011,433645
South Africa,ZAF,1998,189655,191242,6922,23764,37156,28201,476940
South Africa,ZAF,1999,220730,189586,6313,24596,36573,28177,505975
South Africa,ZAF,2000,258728,198835,6149,25764,38992,28569,557037
South Africa,ZAF,2001,293007,197816,5823,26603,38323,28381,589953
South Africa,ZAF,2002,328591,200612,5657,27797,39574,28729,630960
South Africa,ZAF,2003,362033,204154,5550,28839,40964,29022,670562
South Africa,ZAF,2004,388495,203397,5430,29630,40883,28597,696432
South Africa,ZAF,2005,404915,204896,5297,30260,40098,27978,713444
South Africa,ZAF,2006,410313,211311,5232,30314,39963,27120,724253
South Africa,ZAF,2007,399311,210470,5048,29775,38064,25915,708583
South Africa,ZAF,2008,380510,212491,4945,29241,36929,24948,689064
South Africa,ZAF,2009,354511,215590,4780,27652,35296,24052,661881
South Africa,ZAF,2010,328834,218123,4704,25860,33270,23380,634171
South Africa,ZAF,2011,300478,216296,4743,24664,30618,22051,598850
South Africa,ZAF,2012,271980,215525,4801,23877,29564,21768,567515
South Africa,ZAF,2013,251045,217302,4758,23096,28910,21386,546497
South Africa,ZAF,2014,241406,224530,4776,22769,29255,21415,544151
South Africa,ZAF,2015,238369,230336,4741,21580,29031,21015,545072
South Africa,ZAF,2016,240792,231787,4625,20114,28100,19975,545393
South Africa,ZAF,2017,236991,232402,4507,19343,28617,19849,541709
South Africa,ZAF,2018,218765,223203,4299,18838,29953,20473,515531
South Africa,ZAF,2019,208886,222198,4138,18517,30861,20789,505389
South Korea,KOR,1990,13633,195116,728,2879,23523,3236,239115
South Korea,KOR,1991,12628,196731,700,2627,24265,3323,240274
South Korea,KOR,1992,11581,195211,657,2439,24526,3427,237841
South Korea,KOR,1993,10760,195456,655,2254,24914,3516,237555
South Korea,KOR,1994,10314,198022,672,2105,25589,3717,240419
South Korea,KOR,1995,9745,197046,718,1949,25742,3744,238944
South Korea,KOR,1996,9469,197311,761,1820,25761,3767,238889
South Korea,KOR,1997,9385,199006,817,1687,25126,3776,239797
South Korea,KOR,1998,9510,202024,883,1577,25049,3714,242757
South Korea,KOR,1999,9570,204683,863,1487,23773,3608,243984
South Korea,KOR,2000,9585,204932,769,1545,23144,3472,243447
South Korea,KOR,2001,9396,203220,645,1609,22464,3337,240671
South Korea,KOR,2002,9335,203915,535,1573,22551,3226,241135
South Korea,KOR,2003,9272,204084,456,1500,23319,3161,241792
South Korea,KOR,2004,9274,203326,395,1360,22817,3103,240275
South Korea,KOR,2005,9461,202295,355,1202,22768,3013,239094
South Korea,KOR,2006,9717,201445,321,1107,22709,2916,238215
South Korea,KOR,2007,10147,202511,307,1049,23240,2826,240080
South Korea,KOR,2008,10645,203223,296,985,23908,2744,241801
South Korea,KOR,2009,11335,204979,286,926,24651,2672,244849
South Korea,KOR,2010,12368,208572,285,900,24827,2649,249601
South Korea,KOR,2011,13515,211748,290,865,24585,2512,253515
South Korea,KOR,2012,14778,216350,300,835,23997,2449,258709
South Korea,KOR,2013,15603,218080,306,799,23417,2381,260586
South Korea,KOR,2014,16280,220669,314,765,22802,2318,263148
South Korea,KOR,2015,17200,225620,335,718,22078,2273,268224
South Korea,KOR,2016,17951,231488,357,676,21706,2262,274440
South Korea,KOR,2017,18819,243700,384,641,21978,2289,287811
South Korea,KOR,2018,19300,254360,409,609,22336,2327,299341
South Korea,KOR,2019,20025,267926,440,579,22705,2375,314050
South Sudan,SSD,2011,37211,17619,7430,11967,1940,3202,79369
South Sudan,SSD,2012,37190,17924,7097,11906,2010,2322,78449
South Sudan,SSD,2013,37443,18162,6870,11612,2089,4676,80852
South Sudan,SSD,2015,35470,18486,6031,10359,1930,3041,75317
South Sudan,SSD,2016,33522,18524,5490,9491,1853,2811,71691
South Sudan,SSD,1990,29463,15492,16178,8579,1753,571,72036
South Sudan,SSD,1991,29733,15547,16041,8654,1748,581,72304
South Sudan,SSD,1992,30460,15664,16081,8759,1778,606,73348
South Sudan,SSD,1993,31206,15700,16009,8871,1806,634,74226
South Sudan,SSD,1994,31894,15725,15841,8979,1816,656,74911
South Sudan,SSD,1995,33282,15964,16070,9133,1936,719,77104
South Sudan,SSD,1996,33557,15903,15741,9249,1913,730,77093
South Sudan,SSD,1997,33392,15539,15243,9311,1821,7710,83016
South Sudan,SSD,1998,33679,15527,14859,9497,1811,5726,81099
South Sudan,SSD,1999,33901,15456,14339,9675,1784,3736,78891
South Sudan,SSD,2000,34332,15452,13853,9849,1771,2752,78009
South Sudan,SSD,2001,34427,15176,13107,9972,1694,1733,76109
South Sudan,SSD,2002,34380,15181,12448,10144,1672,1734,75559
South Sudan,SSD,2003,34785,15438,11833,10366,1704,1763,75889
South Sudan,SSD,2004,35408,15741,11375,10607,1750,994,75875
South Sudan,SSD,2005,36463,15969,11288,10844,1802,912,77278
South Sudan,SSD,2006,38400,16353,10868,11076,1882,1614,80193
South Sudan,SSD,2007,38461,16625,10140,11291,1931,1346,79794
South Sudan,SSD,2008,38479,16860,9374,11504,1966,1089,79272
South Sudan,SSD,2009,38185,17109,8599,11671,1955,3437,80956
South Sudan,SSD,2010,37575,17366,7882,11849,1941,1746,78359
South Sudan,SSD,2014,36801,18344,6471,11196,1978,4643,79433
South Sudan,SSD,2017,31987,18750,4927,9245,1811,3237,69957
South Sudan,SSD,2018,31052,19217,4571,9445,1835,2775,68895
South Sudan,SSD,2019,30658,19634,4319,9608,2012,1647,67878
Spain,ESP,1990,12883,294593,322,1486,14059,1732,325075
Spain,ESP,1991,13292,298014,333,1378,13802,1867,328686
Spain,ESP,1992,13833,296998,339,1319,13103,1885,327477
Spain,ESP,1993,14555,299762,348,1191,12462,1884,330202
Spain,ESP,1994,15239,302146,361,1049,12086,1936,332817
Spain,ESP,1995,16257,307263,386,957,11799,2039,338701
Spain,ESP,1996,16322,312656,400,939,11837,1941,344095
Spain,ESP,1997,14122,313423,422,881,11685,1972,342505
Spain,ESP,1998,13522,321270,443,845,11679,1961,349720
Spain,ESP,1999,14041,328361,476,844,11674,1956,357352
Spain,ESP,2000,13690,323996,486,853,11482,2019,352526
Spain,ESP,2001,13585,325178,492,849,11252,2039,353395
Spain,ESP,2002,14038,330595,510,893,11119,1996,359151
Spain,ESP,2003,14434,337895,525,929,11017,2193,366993
Spain,ESP,2004,14318,336712,519,935,10506,2526,365516
Spain,ESP,2005,14552,339178,524,933,10125,1985,367297
Spain,ESP,2006,14195,337333,524,914,9562,1946,364474
Spain,ESP,2007,14396,341559,533,942,9204,1841,368475
Spain,ESP,2008,14413,344134,544,937,8736,1845,370609
Spain,ESP,2009,14093,343541,559,886,8204,1777,369060
Spain,ESP,2010,13854,342748,573,855,7755,1714,367499
Spain,ESP,2011,14079,348021,588,816,7516,1702,372722
Spain,ESP,2012,14439,352811,612,752,7362,1660,377636
Spain,ESP,2013,14347,351294,621,681,7082,1620,375645
Spain,ESP,2014,14745,355757,658,681,7004,1609,380454
Spain,ESP,2015,15565,366334,707,632,7003,1594,391835
Spain,ESP,2016,15674,367367,723,615,6899,1596,392874
Spain,ESP,2017,15914,372602,734,571,6880,1618,398319
Spain,ESP,2018,16296,379469,752,533,6981,1647,405678
Spain,ESP,2019,16623,385443,769,498,6993,1660,411986
Sri Lanka,LKA,1990,11457,63293,941,4684,11120,8198,99693
Sri Lanka,LKA,1991,10571,61373,797,4317,10447,9476,96981
Sri Lanka,LKA,1992,10210,62496,722,4362,10318,7246,95354
Sri Lanka,LKA,1993,9355,62672,619,3771,10106,3975,90498
Sri Lanka,LKA,1994,8977,66170,595,3888,10771,2894,93295
Sri Lanka,LKA,1995,9565,70152,570,3751,11835,8155,104028
Sri Lanka,LKA,1996,8999,73836,575,3969,12563,7276,107218
Sri Lanka,LKA,1997,9306,80041,634,3845,13483,5979,113288
Sri Lanka,LKA,1998,8713,80070,604,3209,12584,7069,112249
Sri Lanka,LKA,1999,8802,82991,595,3044,12541,4751,112724
Sri Lanka,LKA,2000,8738,85520,579,3075,12720,5661,116293
Sri Lanka,LKA,2001,7909,84314,535,2949,11597,3849,111153
Sri Lanka,LKA,2002,7578,84968,510,2700,10788,2381,108925
Sri Lanka,LKA,2003,7577,88347,498,2635,10876,2363,112296
Sri Lanka,LKA,2004,7436,89427,470,2501,45538,2324,147696
Sri Lanka,LKA,2005,7717,91466,459,3491,10465,2414,116012
Sri Lanka,LKA,2006,7345,93119,409,2382,10282,5223,118760
Sri Lanka,LKA,2007,7093,94032,390,2057,9946,4871,118389
Sri Lanka,LKA,2008,7059,96113,368,2121,9906,10547,126114
Sri Lanka,LKA,2009,6974,96490,346,2248,9061,12140,127259
Sri Lanka,LKA,2010,6920,97578,330,2191,8624,9873,125516
Sri Lanka,LKA,2011,7025,100740,330,2067,8874,1376,120412
Sri Lanka,LKA,2012,7027,102433,327,1947,8673,1310,121717
Sri Lanka,LKA,2013,6944,102684,323,1870,8377,1248,121446
Sri Lanka,LKA,2014,6982,105040,322,1782,8671,1254,124051
Sri Lanka,LKA,2015,6878,105096,312,1578,8609,1286,123759
Sri Lanka,LKA,2016,6910,107134,312,1453,9013,1320,126142
Sri Lanka,LKA,2017,6939,109112,310,1341,9156,1342,128200
Sri Lanka,LKA,2018,6859,109318,306,1254,9041,1403,128181
Sri Lanka,LKA,2019,6949,112449,311,1177,9025,1695,131606
Sudan,SDN,2007,43944,101293,3940,34314,12406,4348,200245
Sudan,SDN,2008,41012,102156,3658,33697,12215,4214,196952
Sudan,SDN,2009,38859,103117,3359,33066,12162,6089,196652
Sudan,SDN,2010,36397,103882,3016,32383,11930,4006,191614
Sudan,SDN,2011,33767,104713,2784,31586,11709,6439,190998
Sudan,SDN,2012,32383,106088,2597,30768,11741,3739,187316
Sudan,SDN,2013,30634,107374,2399,29836,11733,4577,186553
Sudan,SDN,2014,30249,109060,2322,29052,11886,4513,187082
Sudan,SDN,2015,28996,110855,2164,28065,11768,5027,186875
Sudan,SDN,2016,28184,112815,2007,27189,11929,4352,186476
Sudan,SDN,1990,53728,79302,7732,40796,12900,6681,201139
Sudan,SDN,1991,53540,81725,7638,40789,13057,5955,202704
Sudan,SDN,1992,54129,83982,7654,40683,13193,5496,205137
Sudan,SDN,1993,54490,86004,7654,40161,13303,7415,209027
Sudan,SDN,1994,54855,88018,7640,39611,13328,2357,205809
Sudan,SDN,1995,54816,89721,7530,38892,13296,2877,207132
Sudan,SDN,1996,55042,91301,7411,38357,13385,4148,209644
Sudan,SDN,1997,54043,92679,7214,37918,13188,7050,212092
Sudan,SDN,1998,55258,93840,6948,37486,13220,7860,214612
Sudan,SDN,1999,54594,94721,6595,36911,12913,3684,209418
Sudan,SDN,2000,53038,95583,6487,36478,12715,5157,209458
Sudan,SDN,2001,51555,96343,6095,35971,12475,5261,207700
Sudan,SDN,2002,49112,97362,5632,35455,12327,8036,207924
Sudan,SDN,2003,46733,97823,5011,35051,11967,9929,206514
Sudan,SDN,2004,45248,98611,4661,34861,11862,14443,209686
Sudan,SDN,2005,45999,99837,4579,35005,12244,4116,201780
Sudan,SDN,2006,46086,100647,4322,34799,12306,4799,202959
Sudan,SDN,2017,27974,115061,1864,26183,11752,2659,185493
Sudan,SDN,2018,25426,117596,1668,24939,11816,3063,184508
Sudan,SDN,2019,24105,120173,1520,23831,11744,1878,183251
Suriname,SUR,1990,344,1670,51,234,209,44,2552
Suriname,SUR,1991,321,1750,51,227,220,47,2616
Suriname,SUR,1992,315,1800,50,221,233,47,2666
Suriname,SUR,1993,340,1902,49,218,251,49,2809
Suriname,SUR,1994,327,1782,44,216,236,48,2653
Suriname,SUR,1995,303,1558,39,215,201,45,2361
Suriname,SUR,1996,319,1548,37,216,188,46,2354
Suriname,SUR,1997,320,1596,36,218,191,48,2409
Suriname,SUR,1998,330,1736,37,219,209,52,2583
Suriname,SUR,1999,344,1881,37,222,223,55,2762
Suriname,SUR,2000,438,1966,35,219,214,54,2926
Suriname,SUR,2001,466,2057,35,216,213,54,3041
Suriname,SUR,2002,451,2158,35,212,226,57,3139
Suriname,SUR,2003,418,2201,34,208,241,62,3164
Suriname,SUR,2004,405,2226,33,204,250,63,3181
Suriname,SUR,2005,380,2215,31,204,250,65,3145
Suriname,SUR,2006,350,2221,31,202,255,66,3125
Suriname,SUR,2007,332,2249,29,201,265,68,3144
Suriname,SUR,2008,319,2307,29,198,273,67,3193
Suriname,SUR,2009,314,2352,28,194,274,68,3230
Suriname,SUR,2010,319,2401,27,190,276,68,3281
Suriname,SUR,2011,304,2425,25,185,272,68,3279
Suriname,SUR,2012,303,2478,25,180,263,65,3314
Suriname,SUR,2013,302,2630,25,177,267,67,3468
Suriname,SUR,2014,331,2787,27,172,264,66,3647
Suriname,SUR,2015,322,2935,27,166,278,70,3798
Suriname,SUR,2016,322,3041,27,160,285,70,3905
Suriname,SUR,2017,322,3136,27,152,287,71,3995
Suriname,SUR,2018,321,3223,27,147,286,71,4075
Suriname,SUR,2019,319,3297,28,142,287,71,4144
Sweden,SWE,1990,4649,81058,102,287,3091,763,89950
Sweden,SWE,1991,4655,81745,111,285,3068,779,90643
Sweden,SWE,1992,4642,81876,115,252,2953,775,90613
Sweden,SWE,1993,4677,82329,120,229,2892,776,91023
Sweden,SWE,1994,4466,80556,121,198,2782,780,88903
Sweden,SWE,1995,4443,81273,124,168,2691,784,89483
Sweden,SWE,1996,4392,81675,129,153,2584,823,89756
Sweden,SWE,1997,4169,81634,141,140,2489,865,89438
Sweden,SWE,1998,4005,81881,146,137,2479,910,89558
Sweden,SWE,1999,3965,82130,159,131,2373,950,89708
Sweden,SWE,2000,3837,81769,164,136,2308,958,89172
Sweden,SWE,2001,3703,81763,172,148,2292,957,89035
Sweden,SWE,2002,3664,81917,177,148,2241,975,89122
Sweden,SWE,2003,3532,81022,172,146,2207,970,88049
Sweden,SWE,2004,3403,80503,171,140,2202,985,87404
Sweden,SWE,2005,3382,79915,175,131,2148,957,86708
Sweden,SWE,2006,3349,80251,185,136,2122,935,86978
Sweden,SWE,2007,3382,80136,185,127,2112,952,86894
Sweden,SWE,2008,3371,79513,186,130,2099,931,86230
Sweden,SWE,2009,3384,79285,187,140,2079,929,86004
Sweden,SWE,2010,3368,79285,193,138,2026,925,85935
Sweden,SWE,2011,3501,79657,197,127,2015,909,86406
Sweden,SWE,2012,3557,79639,204,143,2016,904,86463
Sweden,SWE,2013,3565,79226,211,147,2028,927,86104
Sweden,SWE,2014,3518,78826,222,134,1999,950,85649
Sweden,SWE,2015,3642,79416,231,142,1984,989,86404
Sweden,SWE,2016,3711,80364,242,146,1953,1004,87420
Sweden,SWE,2017,3776,81200,243,140,1936,1044,88339
Sweden,SWE,2018,3744,82053,239,132,1928,1043,89139
Sweden,SWE,2019,3721,82303,234,128,1919,1061,89366
Switzerland,CHE,1990,2923,51642,132,223,2986,694,58600
Switzerland,CHE,1991,2894,51867,130,216,3010,732,58849
Switzerland,CHE,1992,2858,51566,124,211,2947,773,58479
Switzerland,CHE,1993,2812,51539,118,195,2860,800,58324
Switzerland,CHE,1994,2704,51877,112,186,2812,799,58490
Switzerland,CHE,1995,3057,54163,95,186,2626,748,60875
Switzerland,CHE,1996,2850,54146,86,184,2479,713,60458
Switzerland,CHE,1997,2709,54297,81,184,2405,701,60377
Switzerland,CHE,1998,2612,54270,78,181,2338,665,60144
Switzerland,CHE,1999,2537,54202,78,184,2296,666,59963
Switzerland,CHE,2000,2474,54238,80,185,2306,660,59943
Switzerland,CHE,2001,2291,53695,79,181,2234,674,59154
Switzerland,CHE,2002,2254,53985,82,173,2216,640,59350
Switzerland,CHE,2003,2209,54332,82,168,2155,611,59557
Switzerland,CHE,2004,2116,53560,81,172,2098,598,58625
Switzerland,CHE,2005,2072,53568,80,168,2054,584,58526
Switzerland,CHE,2006,2006,53599,82,174,1987,561,58409
Switzerland,CHE,2007,1951,53839,87,167,1934,558,58536
Switzerland,CHE,2008,1914,54034,91,171,1874,552,58636
Switzerland,CHE,2009,1921,54575,101,180,1820,552,59149
Switzerland,CHE,2010,1893,54728,112,172,1753,534,59192
Switzerland,CHE,2011,1912,54837,122,168,1708,530,59277
Switzerland,CHE,2012,1977,55907,138,167,1681,526,60396
Switzerland,CHE,2013,2012,56590,152,171,1666,523,61114
Switzerland,CHE,2014,2053,56985,162,175,1622,518,61515
Switzerland,CHE,2015,2183,57977,178,180,1603,525,62646
Switzerland,CHE,2016,2173,58209,176,166,1582,518,62824
Switzerland,CHE,2017,2203,58841,171,161,1596,537,63509
Switzerland,CHE,2018,2253,59893,171,156,1601,550,64624
Switzerland,CHE,2019,2305,61045,171,152,1604,564,65841
Syria,SYR,2007,2972,51368,213,2832,2968,1239,61592
Syria,SYR,2008,3375,54001,229,3104,3080,970,64759
Syria,SYR,2009,3513,54785,214,2920,3066,816,65314
Syria,SYR,2010,3680,56755,199,2842,3134,767,67377
Syria,SYR,1990,6082,42741,885,11135,2905,511,64259
Syria,SYR,1991,5904,44121,802,10782,2973,459,65041
Syria,SYR,1992,5667,46402,731,10307,3082,463,66652
Syria,SYR,1993,5378,45636,662,9732,3006,459,64873
Syria,SYR,1994,5128,46523,605,9077,3018,469,64820
Syria,SYR,1995,4894,47605,565,8370,3028,490,64952
Syria,SYR,1996,4428,48125,504,7586,3037,523,64203
Syria,SYR,1997,4064,48969,457,6839,3040,633,64002
Syria,SYR,1998,3767,50868,417,6113,3089,593,64847
Syria,SYR,1999,3416,50753,387,5339,3021,616,63532
Syria,SYR,2000,3104,50135,324,4554,2945,621,61683
Syria,SYR,2001,2843,48753,297,4003,2886,625,59407
Syria,SYR,2002,2742,49304,282,3580,2956,703,59567
Syria,SYR,2003,2433,47589,231,2852,2671,669,56445
Syria,SYR,2004,2464,48208,218,2709,2709,617,56925
Syria,SYR,2005,2583,48785,216,2766,2812,685,57847
Syria,SYR,2006,2783,49876,215,2880,2943,1705,60402
Syria,SYR,2011,3772,58523,208,2809,3073,13643,82028
Syria,SYR,2012,3654,59362,204,2504,2843,60847,129414
Syria,SYR,2013,3483,60788,194,2178,2667,50352,119662
Syria,SYR,2014,3312,61509,186,1910,2550,75949,145416
Syria,SYR,2015,3091,61329,174,1681,2491,61516,130282
Syria,SYR,2016,2953,62824,168,1473,2403,55005,124826
Syria,SYR,2017,2852,65056,167,1311,2385,32437,104208
Syria,SYR,2018,2765,67013,160,1199,2470,11405,85012
Syria,SYR,2019,2721,68866,157,1136,2505,7510,82895
Taiwan,TWN,2007,9049,118594,189,483,10201,1190,139706
Taiwan,TWN,2008,9818,120055,207,469,9857,1133,141539
Taiwan,TWN,2009,10170,120526,205,385,10010,1190,142486
Taiwan,TWN,2010,10609,122703,206,357,9174,1112,144161
Taiwan,TWN,2011,11474,129178,214,474,9245,1106,151691
Taiwan,TWN,2012,11726,130700,212,464,8979,1155,153236
Taiwan,TWN,2013,11876,131572,204,394,8575,1175,153796
Taiwan,TWN,2014,12652,137627,208,418,8619,1235,160759
Taiwan,TWN,2015,12958,138331,203,464,8408,1244,161608
Taiwan,TWN,2016,13853,145005,218,438,8705,1274,169493
Taiwan,TWN,1990,6455,81516,518,571,11741,1592,102393
Taiwan,TWN,1991,6377,82972,501,539,11528,1551,103468
Taiwan,TWN,1992,6488,85712,500,563,11465,1519,106247
Taiwan,TWN,1993,6473,87778,469,586,11493,1511,108310
Taiwan,TWN,1994,6582,91033,443,659,11551,1574,111842
Taiwan,TWN,1995,6758,94692,411,858,11505,1760,115984
Taiwan,TWN,1996,6920,98282,376,965,11465,1766,119774
Taiwan,TWN,1997,6860,98376,322,941,10989,1694,119182
Taiwan,TWN,1998,7048,100821,284,847,10709,1624,121333
Taiwan,TWN,1999,6977,101730,237,869,12676,1507,123996
Taiwan,TWN,2000,7108,104835,213,868,10505,1468,124997
Taiwan,TWN,2001,7254,106894,208,746,10568,1420,127090
Taiwan,TWN,2002,7500,106799,191,666,10366,1390,126912
Taiwan,TWN,2003,7663,109887,183,569,10296,1311,129909
Taiwan,TWN,2004,8019,113856,189,560,10617,1274,134515
Taiwan,TWN,2005,8446,117624,190,529,10975,1283,139047
Taiwan,TWN,2006,8572,116965,188,496,10684,1254,138159
Taiwan,TWN,2017,14037,149137,229,399,8690,1317,173809
Taiwan,TWN,2018,14083,152619,234,373,8894,1356,177559
Taiwan,TWN,2019,14389,157403,242,353,8856,1379,182622
Tajikistan,TJK,1990,13680,20430,71,3111,2129,547,39968
Tajikistan,TJK,1991,13366,21260,79,3124,2096,659,40584
Tajikistan,TJK,1992,13606,22674,87,3143,3842,4725,48077
Tajikistan,TJK,1993,13683,24020,100,3165,2355,16949,60272
Tajikistan,TJK,1994,13607,25998,125,3217,2525,1620,47092
Tajikistan,TJK,1995,13322,24515,147,3209,2387,1666,45246
Tajikistan,TJK,1996,12942,23752,178,3177,2283,4053,46385
Tajikistan,TJK,1997,12393,24170,190,3134,2234,1232,43353
Tajikistan,TJK,1998,11882,25325,211,3104,2137,1584,44243
Tajikistan,TJK,1999,11176,25576,239,3078,2002,839,42910
Tajikistan,TJK,2000,10546,25682,260,3047,1908,789,42232
Tajikistan,TJK,2001,9913,26109,274,3039,1857,785,41977
Tajikistan,TJK,2002,9222,26345,276,3026,1845,654,41368
Tajikistan,TJK,2003,8569,26709,272,3037,1780,561,40928
Tajikistan,TJK,2004,7963,27305,262,3085,1790,540,40945
Tajikistan,TJK,2005,7622,28281,229,3091,1831,502,41556
Tajikistan,TJK,2006,7397,28890,194,3112,1866,492,41951
Tajikistan,TJK,2007,7107,29586,164,3133,1890,473,42353
Tajikistan,TJK,2008,6824,30200,138,3162,1862,462,42648
Tajikistan,TJK,2009,6636,30656,115,3187,1902,467,42963
Tajikistan,TJK,2010,6435,31938,94,3169,1971,550,44157
Tajikistan,TJK,2011,6229,32876,77,3152,1914,469,44717
Tajikistan,TJK,2012,6069,33236,62,3135,1912,486,44900
Tajikistan,TJK,2013,5915,33271,49,3103,1879,426,44643
Tajikistan,TJK,2014,5825,34153,40,3096,1900,423,45437
Tajikistan,TJK,2015,5622,35201,32,3058,1935,432,46280
Tajikistan,TJK,2016,5442,36501,24,3016,1961,402,47346
Tajikistan,TJK,2017,5359,36873,27,2957,1996,422,47634
Tajikistan,TJK,2018,5188,36263,27,2860,2014,448,46800
Tajikistan,TJK,2019,5098,36461,27,2775,2049,458,46868
Tanzania,TZA,1990,171923,66603,24531,34275,7512,2733,307577
Tanzania,TZA,1991,183813,68046,25779,34414,7373,2780,322205
Tanzania,TZA,1992,198106,69702,26948,34638,7450,2828,339672
Tanzania,TZA,1993,209112,71552,27978,35010,7604,2892,354148
Tanzania,TZA,1994,221734,73251,28454,35495,7747,2946,369627
Tanzania,TZA,1995,233159,74733,28284,35910,7728,3002,382816
Tanzania,TZA,1996,241881,76158,27642,36577,7802,3068,393128
Tanzania,TZA,1997,251775,78037,26591,37325,8090,3267,405085
Tanzania,TZA,1998,257354,80353,25210,38215,8268,3258,412658
Tanzania,TZA,1999,258401,82429,24144,39071,8297,3317,415659
Tanzania,TZA,2000,258004,83807,22801,39683,8291,3388,415974
Tanzania,TZA,2001,258379,85147,21373,40036,8343,3585,416863
Tanzania,TZA,2002,256548,87022,20760,40546,8555,3718,417149
Tanzania,TZA,2003,252529,89897,20768,41277,8839,3747,417057
Tanzania,TZA,2004,245917,92449,20380,41988,9060,3895,413689
Tanzania,TZA,2005,238861,94757,20038,42770,9157,3997,409580
Tanzania,TZA,2006,228535,97801,19182,43735,9505,4123,402881
Tanzania,TZA,2007,210786,100754,19161,44939,9667,4248,389555
Tanzania,TZA,2008,196325,103304,18369,45758,9807,4312,377875
Tanzania,TZA,2009,192218,106001,18650,46637,10105,4460,378071
Tanzania,TZA,2010,185332,107863,18127,47059,10165,4542,373088
Tanzania,TZA,2011,176375,110227,17780,47327,10366,4599,366674
Tanzania,TZA,2012,164333,113551,17897,47589,10613,4756,358739
Tanzania,TZA,2013,149379,116617,17572,47841,10850,4878,347137
Tanzania,TZA,2014,139708,118118,16102,47416,10680,4866,336890
Tanzania,TZA,2015,138632,120982,16503,47017,11071,5052,339257
Tanzania,TZA,2016,135255,124256,16043,46582,11220,5148,338504
Tanzania,TZA,2017,129516,128138,15461,46213,11327,5169,335824
Tanzania,TZA,2018,122003,131785,14383,45557,11456,5241,330425
Tanzania,TZA,2019,117443,135036,13500,45100,11523,5286,327888
Thailand,THA,2007,50145,271259,1447,4495,34450,8124,369920
Thailand,THA,2008,49227,276705,1435,4219,33956,7431,372973
Thailand,THA,2009,48860,280218,1414,3798,33163,7015,374468
Thailand,THA,1990,37578,185958,3288,12022,35833,10385,285064
Thailand,THA,1991,38082,195881,3215,11217,37575,10744,296714
Thailand,THA,1992,39443,203393,3123,10525,39144,10948,306576
Thailand,THA,1993,41973,210562,3037,9953,41937,11275,318737
Thailand,THA,1994,45940,218859,2967,9467,46095,11778,335106
Thailand,THA,1995,49739,226497,2895,9024,50510,12197,350862
Thailand,THA,1996,53185,234342,2832,8529,53379,12341,364608
Thailand,THA,1997,54654,224167,2623,7894,48755,11719,349812
Thailand,THA,1998,58349,233089,2563,7493,45624,11701,358819
Thailand,THA,1999,62060,250377,2428,7130,47241,11654,380890
Thailand,THA,2000,63940,251914,2137,6731,45901,11258,381881
Thailand,THA,2001,64072,241275,1805,6289,44064,10647,368152
Thailand,THA,2002,64550,247591,1658,5952,44224,10358,374333
Thailand,THA,2003,63420,250768,1512,5600,42846,10041,374187
Thailand,THA,2004,61929,256752,1512,5227,47842,9182,382444
Thailand,THA,2005,58318,260847,1494,4836,36579,8649,370723
Thailand,THA,2006,53256,265608,1465,4624,35502,8349,368804
Thailand,THA,2010,50005,289606,1429,3397,33400,6879,384716
Thailand,THA,2011,50694,294530,1409,3173,33489,6875,390170
Thailand,THA,2012,52481,298654,1422,3077,32433,6845,394912
Thailand,THA,2013,56135,303134,1473,2832,31410,6771,401755
Thailand,THA,2014,59612,312782,1533,2737,31269,5658,413591
Thailand,THA,2015,61841,323593,1596,2624,31459,5519,426632
Thailand,THA,2016,63520,340380,1681,2608,32334,5580,446103
Thailand,THA,2017,63746,352808,1765,2285,32285,5489,458378
Thailand,THA,2018,63819,366914,1850,2108,32008,5623,472322
Thailand,THA,2019,63469,380188,1926,1974,31861,5414,484832
Timor,TLS,1990,2868,1682,1036,1082,291,255,7214
Timor,TLS,1991,2860,1705,955,1065,288,402,7275
Timor,TLS,1992,2763,1765,896,1056,294,338,7112
Timor,TLS,1993,2682,1817,839,1045,294,419,7096
Timor,TLS,1994,2631,1846,774,1026,289,338,6904
Timor,TLS,1995,2561,1890,714,1008,282,418,6873
Timor,TLS,1996,2469,1922,654,996,272,43,6356
Timor,TLS,1997,2422,1936,602,976,255,496,6687
Timor,TLS,1998,2297,2021,581,970,256,512,6637
Timor,TLS,1999,2248,2091,560,960,253,2658,8770
Timor,TLS,2000,2115,2193,518,939,256,123,6144
Timor,TLS,2001,2051,2272,474,917,250,139,6103
Timor,TLS,2002,2050,2355,424,894,241,152,6116
Timor,TLS,2003,1994,2483,381,881,251,93,6083
Timor,TLS,2004,2128,2527,329,840,220,33,6077
Timor,TLS,2005,2002,2646,290,807,221,36,6002
Timor,TLS,2006,1904,2718,243,755,207,85,5912
Timor,TLS,2007,1813,2848,213,719,210,72,5875
Timor,TLS,2008,1816,2944,182,679,193,35,5849
Timor,TLS,2009,1675,3150,164,659,205,34,5887
Timor,TLS,2010,1665,3367,151,637,210,35,6065
Timor,TLS,2011,1488,3638,145,631,234,39,6175
Timor,TLS,2012,1398,3857,141,621,254,42,6313
Timor,TLS,2013,1382,4039,135,607,260,43,6466
Timor,TLS,2014,1389,4204,131,603,270,44,6641
Timor,TLS,2015,1402,4415,127,608,280,45,6877
Timor,TLS,2016,1422,4571,125,606,289,48,7061
Timor,TLS,2017,1417,4732,121,594,293,50,7207
Timor,TLS,2018,1413,4878,123,588,298,51,7351
Timor,TLS,2019,1410,4997,123,586,304,52,7472
Togo,TGO,1990,18402,8140,1604,5609,1301,295,35351
Togo,TGO,1991,18793,8358,1618,5654,1358,386,36167
Togo,TGO,1992,19192,8578,1627,5694,1386,346,36823
Togo,TGO,1993,19888,8824,1643,5733,1446,398,37932
Togo,TGO,1994,20672,9106,1635,5768,1492,415,39088
Togo,TGO,1995,21498,9379,1604,5775,1545,390,40191
Togo,TGO,1996,22570,9672,1559,5792,1575,412,41580
Togo,TGO,1997,24057,10004,1500,5794,1636,432,43423
Togo,TGO,1998,25159,10331,1446,5818,1677,463,44894
Togo,TGO,1999,26133,10545,1381,5851,1703,471,46084
Togo,TGO,2000,27524,10885,1260,5864,1719,480,47732
Togo,TGO,2001,28838,11203,1113,5922,1743,494,49313
Togo,TGO,2002,30621,11595,1056,6006,1826,512,51616
Togo,TGO,2003,31517,12009,965,6059,1874,523,52947
Togo,TGO,2004,32046,12261,888,6098,1876,525,53694
Togo,TGO,2005,32257,12637,836,6158,1899,973,54760
Togo,TGO,2006,32232,13000,790,6166,1925,550,54663
Togo,TGO,2007,32210,13463,739,6201,2020,568,55201
Togo,TGO,2008,31832,14121,713,6199,2069,597,55531
Togo,TGO,2009,30915,14715,693,6186,2139,629,55277
Togo,TGO,2010,29632,15204,659,6134,2192,647,54468
Togo,TGO,2011,28791,15534,635,6037,2191,663,53851
Togo,TGO,2012,28455,15808,601,5891,2178,664,53597
Togo,TGO,2013,28094,16100,565,5799,2162,676,53396
Togo,TGO,2014,27492,16598,552,5722,2215,691,53270
Togo,TGO,2015,26657,17231,532,5601,2228,706,52955
Togo,TGO,2016,25234,17898,515,5481,2292,734,52154
Togo,TGO,2017,23610,18662,499,5337,2343,766,51217
Togo,TGO,2018,22468,19127,471,5194,2335,760,50355
Togo,TGO,2019,21923,19688,457,5069,2344,772,50253
Tokelau,TKL,1990,1,11,0,1,0,0,13
Tokelau,TKL,1991,1,11,0,1,0,0,13
Tokelau,TKL,1992,1,11,0,1,0,0,13
Tokelau,TKL,1993,1,11,0,0,0,0,12
Tokelau,TKL,1994,1,10,0,0,0,0,11
Tokelau,TKL,1995,1,10,0,0,0,0,11
Tokelau,TKL,1996,1,10,0,0,0,0,11
Tokelau,TKL,1997,1,10,0,0,0,0,11
Tokelau,TKL,1998,1,10,0,0,0,0,11
Tokelau,TKL,1999,1,10,0,0,0,0,11
Tokelau,TKL,2000,1,10,0,0,0,0,11
Tokelau,TKL,2001,1,11,0,0,0,0,12
Tokelau,TKL,2002,1,11,0,0,0,0,12
Tokelau,TKL,2003,1,10,0,0,0,0,11
Tokelau,TKL,2004,1,10,0,0,0,0,11
Tokelau,TKL,2005,1,9,0,0,0,0,10
Tokelau,TKL,2006,1,8,0,0,0,0,9
Tokelau,TKL,2007,1,8,0,0,0,0,9
Tokelau,TKL,2008,1,8,0,0,0,0,9
Tokelau,TKL,2009,1,8,0,0,0,0,9
Tokelau,TKL,2010,1,7,0,0,0,0,8
Tokelau,TKL,2011,1,7,0,0,0,0,8
Tokelau,TKL,2012,1,7,0,0,0,0,8
Tokelau,TKL,2013,1,7,0,0,0,0,8
Tokelau,TKL,2014,0,7,0,0,0,0,7
Tokelau,TKL,2015,0,7,0,0,0,0,7
Tokelau,TKL,2016,0,8,0,0,0,0,8
Tokelau,TKL,2017,0,8,0,0,0,0,8
Tokelau,TKL,2018,0,8,0,0,0,0,8
Tokelau,TKL,2019,0,9,0,0,0,0,9
Tonga,TON,1990,59,363,8,28,22,8,488
Tonga,TON,1991,59,369,8,28,21,8,493
Tonga,TON,1992,59,372,8,27,21,8,495
Tonga,TON,1993,59,383,8,27,21,8,506
Tonga,TON,1994,60,390,8,27,21,8,514
Tonga,TON,1995,60,392,8,27,21,7,515
Tonga,TON,1996,59,402,8,26,21,7,523
Tonga,TON,1997,60,419,8,26,21,6,540
Tonga,TON,1998,62,446,8,26,23,5,570
Tonga,TON,1999,65,471,8,26,25,6,601
Tonga,TON,2000,65,474,8,26,25,5,603
Tonga,TON,2001,63,473,8,25,24,5,598
Tonga,TON,2002,61,480,8,25,25,5,604
Tonga,TON,2003,61,489,8,25,25,4,612
Tonga,TON,2004,60,484,8,24,24,3,603
Tonga,TON,2005,56,467,8,23,24,3,581
Tonga,TON,2006,56,474,8,23,24,4,589
Tonga,TON,2007,56,482,8,23,24,4,597
Tonga,TON,2008,58,491,8,23,24,4,608
Tonga,TON,2009,57,498,8,21,33,4,621
Tonga,TON,2010,57,504,8,20,24,4,617
Tonga,TON,2011,56,510,8,19,24,4,621
Tonga,TON,2012,56,515,8,19,24,4,626
Tonga,TON,2013,56,519,8,18,24,4,629
Tonga,TON,2014,56,525,8,17,25,4,635
Tonga,TON,2015,55,528,8,16,24,4,635
Tonga,TON,2016,55,531,8,16,24,4,638
Tonga,TON,2017,53,535,7,15,24,4,638
Tonga,TON,2018,53,538,7,14,23,4,639
Tonga,TON,2019,53,540,7,14,23,4,641
Trinidad and Tobago,TTO,1990,562,6315,88,366,454,172,7957
Trinidad and Tobago,TTO,1991,575,6392,88,344,448,151,7998
Trinidad and Tobago,TTO,1992,631,6593,88,331,449,166,8258
Trinidad and Tobago,TTO,1993,657,6949,88,321,472,169,8656
Trinidad and Tobago,TTO,1994,704,7188,87,312,459,196,8946
Trinidad and Tobago,TTO,1995,692,7016,82,307,449,181,8727
Trinidad and Tobago,TTO,1996,764,7319,82,293,467,177,9102
Trinidad and Tobago,TTO,1997,738,7135,76,291,440,158,8838
Trinidad and Tobago,TTO,1998,779,7492,74,284,467,165,9261
Trinidad and Tobago,TTO,1999,903,7641,72,286,468,169,9539
Trinidad and Tobago,TTO,2000,880,7359,67,293,469,168,9236
Trinidad and Tobago,TTO,2001,858,7484,66,285,489,205,9387
Trinidad and Tobago,TTO,2002,823,7403,64,273,479,220,9262
Trinidad and Tobago,TTO,2003,766,7705,63,265,491,286,9576
Trinidad and Tobago,TTO,2004,666,7653,60,250,502,332,9463
Trinidad and Tobago,TTO,2005,647,7614,55,234,494,418,9462
Trinidad and Tobago,TTO,2006,615,7493,51,223,484,432,9298
Trinidad and Tobago,TTO,2007,568,7580,49,207,496,470,9370
Trinidad and Tobago,TTO,2008,569,7950,47,204,530,546,9846
Trinidad and Tobago,TTO,2009,546,7702,46,196,489,534,9513
Trinidad and Tobago,TTO,2010,519,7722,45,191,468,509,9454
Trinidad and Tobago,TTO,2011,501,7636,39,179,436,440,9231
Trinidad and Tobago,TTO,2012,504,7550,37,171,404,420,9086
Trinidad and Tobago,TTO,2013,516,7931,41,168,412,401,9469
Trinidad and Tobago,TTO,2014,521,8269,43,162,410,391,9796
Trinidad and Tobago,TTO,2015,525,8575,45,156,404,381,10086
Trinidad and Tobago,TTO,2016,532,9001,47,149,405,376,10510
Trinidad and Tobago,TTO,2017,534,9277,49,143,404,370,10777
Trinidad and Tobago,TTO,2018,536,9544,51,137,401,364,11033
Trinidad and Tobago,TTO,2019,537,9816,51,132,399,361,11296
Tunisia,TUN,1990,3182,25442,126,5546,3227,272,37795
Tunisia,TUN,1991,3065,27203,120,5327,3270,281,39266
Tunisia,TUN,1992,2935,28422,111,5084,3328,282,40162
Tunisia,TUN,1993,2819,29656,105,4843,3387,290,41100
Tunisia,TUN,1994,2674,30325,94,4572,3375,294,41334
Tunisia,TUN,1995,2593,32333,86,4314,3427,305,43058
Tunisia,TUN,1996,2460,33253,80,4029,3397,298,43517
Tunisia,TUN,1997,2351,34463,72,3757,3388,301,44332
Tunisia,TUN,1998,2264,35625,66,3482,3398,304,45139
Tunisia,TUN,1999,2220,36515,62,3277,3423,315,45812
Tunisia,TUN,2000,2189,37371,60,3119,3443,328,46510
Tunisia,TUN,2001,2171,38249,58,2966,3450,332,47226
Tunisia,TUN,2002,2157,39148,56,2809,3453,356,47979
Tunisia,TUN,2003,2153,40085,53,2658,3483,338,48770
Tunisia,TUN,2004,2137,40967,53,2480,3448,340,49425
Tunisia,TUN,2005,2140,41921,52,2348,3442,342,50245
Tunisia,TUN,2006,2151,42871,51,2231,3441,346,51091
Tunisia,TUN,2007,2164,43858,51,2127,3428,372,52000
Tunisia,TUN,2008,2185,44971,51,2041,3385,345,52978
Tunisia,TUN,2009,2210,46055,51,1975,3393,346,54030
Tunisia,TUN,2010,2246,47287,51,1939,3377,348,55248
Tunisia,TUN,2011,2257,48310,51,1861,3351,369,56199
Tunisia,TUN,2012,2266,49486,52,1704,3330,357,57195
Tunisia,TUN,2013,2286,50811,51,1585,3304,424,58461
Tunisia,TUN,2014,2308,52107,52,1470,3292,445,59674
Tunisia,TUN,2015,2325,53465,50,1358,3292,459,60949
Tunisia,TUN,2016,2348,54896,52,1247,3284,430,62257
Tunisia,TUN,2017,2377,56352,51,1142,3283,369,63574
Tunisia,TUN,2018,2389,57640,51,1035,3249,380,64744
Tunisia,TUN,2019,2400,58797,51,949,3222,378,65797
Turkey,TUR,1990,44094,235633,2405,46732,13949,4336,347149
Turkey,TUR,1991,41289,238677,2228,44554,13858,4189,344795
Turkey,TUR,1992,39077,241570,2074,42300,14669,6495,346185
Turkey,TUR,1993,37229,245699,1933,39854,13849,6058,344622
Turkey,TUR,1994,36039,250404,1840,37967,13745,8676,348671
Turkey,TUR,1995,34737,253129,1754,36186,13856,6943,346605
Turkey,TUR,1996,32571,252204,1630,33708,13279,7049,340441
Turkey,TUR,1997,30723,256073,1520,31653,12840,5935,338744
Turkey,TUR,1998,28740,256322,1412,29738,12942,5553,334707
Turkey,TUR,1999,26619,249913,1306,27665,30853,4907,341263
Turkey,TUR,2000,23887,241764,1210,25669,12141,3720,308391
Turkey,TUR,2001,21724,250257,1154,24328,11154,3507,312124
Turkey,TUR,2002,19786,260847,1068,23017,10268,3106,318092
Turkey,TUR,2003,16884,263407,1032,21408,10072,3049,315852
Turkey,TUR,2004,14630,264493,980,19606,9764,2981,312454
Turkey,TUR,2005,13065,265937,934,17685,9483,3036,310140
Turkey,TUR,2006,12176,276591,937,15768,9289,2807,317568
Turkey,TUR,2007,11699,288827,958,14173,9035,2933,327625
Turkey,TUR,2008,11311,305069,1009,12959,8918,2841,342107
Turkey,TUR,2009,11476,324001,1067,12197,9445,2515,360701
Turkey,TUR,2010,11612,335028,1103,11547,9876,2601,371767
Turkey,TUR,2011,11889,343544,1194,10518,10591,2787,380523
Turkey,TUR,2012,12455,349937,1313,10050,10266,3376,387397
Turkey,TUR,2013,13513,360916,1493,9921,10895,3819,400557
Turkey,TUR,2014,14659,369514,1619,9795,11416,3747,410750
Turkey,TUR,2015,15529,371860,1680,9417,11541,4178,414205
Turkey,TUR,2016,16519,379398,1765,9032,11695,5264,423673
Turkey,TUR,2017,17088,387846,1782,8321,11679,3148,429864
Turkey,TUR,2018,17050,390764,1746,7749,11546,4207,433062
Turkey,TUR,2019,17140,398376,1731,7227,11447,2996,438917
Turkmenistan,TKM,1990,7205,15864,68,1809,1687,401,27034
Turkmenistan,TKM,1991,6905,16657,63,1835,1713,841,28014
Turkmenistan,TKM,1992,6736,17132,57,1811,1709,744,28189
Turkmenistan,TKM,1993,6733,19392,55,1744,1820,521,30265
Turkmenistan,TKM,1994,6709,20179,51,1643,1794,451,30827
Turkmenistan,TKM,1995,6529,20088,48,1583,1720,479,30447
Turkmenistan,TKM,1996,6417,20896,46,1538,1761,530,31188
Turkmenistan,TKM,1997,6309,20846,43,1501,1803,563,31065
Turkmenistan,TKM,1998,5976,20495,42,1491,1818,653,30475
Turkmenistan,TKM,1999,5440,20014,34,1517,1766,662,29433
Turkmenistan,TKM,2000,5019,19626,32,1494,1573,567,28311
Turkmenistan,TKM,2001,4638,19858,29,1503,1543,587,28158
Turkmenistan,TKM,2002,4256,21005,28,1530,1576,602,28997
Turkmenistan,TKM,2003,4014,21958,26,1543,1536,622,29699
Turkmenistan,TKM,2004,3818,23357,25,1559,1581,661,31001
Turkmenistan,TKM,2005,3683,24874,25,1580,1616,714,32492
Turkmenistan,TKM,2006,3489,25150,26,1599,1569,675,32508
Turkmenistan,TKM,2007,3358,25121,25,1612,1471,686,32273
Turkmenistan,TKM,2008,3213,24591,25,1626,1354,679,31488
Turkmenistan,TKM,2009,3008,22744,23,1634,1177,635,29221
Turkmenistan,TKM,2010,2819,22419,21,1627,1092,704,28682
Turkmenistan,TKM,2011,2688,23346,21,1621,1045,644,29365
Turkmenistan,TKM,2012,2541,24091,20,1591,1005,651,29899
Turkmenistan,TKM,2013,2478,25276,20,1553,994,636,30957
Turkmenistan,TKM,2014,2398,26379,18,1501,982,620,31898
Turkmenistan,TKM,2015,2302,27239,17,1467,972,618,32615
Turkmenistan,TKM,2016,2224,27764,17,1377,980,625,32987
Turkmenistan,TKM,2017,2140,28236,17,1303,977,625,33298
Turkmenistan,TKM,2018,2066,29151,17,1233,972,628,34067
Turkmenistan,TKM,2019,1996,29692,17,1168,969,633,34475
Tuvalu,TUV,1990,17,69,2,8,6,1,103
Tuvalu,TUV,1991,16,70,2,8,6,1,103
Tuvalu,TUV,1992,15,69,2,7,6,1,100
Tuvalu,TUV,1993,13,71,2,7,6,1,100
Tuvalu,TUV,1994,13,71,2,6,6,1,99
Tuvalu,TUV,1995,11,72,2,5,6,1,97
Tuvalu,TUV,1996,11,73,2,5,5,1,97
Tuvalu,TUV,1997,11,74,2,5,6,1,99
Tuvalu,TUV,1998,10,75,2,4,5,1,97
Tuvalu,TUV,1999,10,75,2,4,5,1,97
Tuvalu,TUV,2000,10,75,2,4,23,1,115
Tuvalu,TUV,2001,10,74,2,3,5,1,95
Tuvalu,TUV,2002,9,76,2,3,5,1,96
Tuvalu,TUV,2003,9,76,2,3,5,1,96
Tuvalu,TUV,2004,8,76,0,3,5,1,93
Tuvalu,TUV,2005,8,77,0,2,5,1,93
Tuvalu,TUV,2006,8,77,0,2,5,1,93
Tuvalu,TUV,2007,7,79,0,2,6,1,95
Tuvalu,TUV,2008,7,80,0,2,6,1,96
Tuvalu,TUV,2009,7,81,0,2,6,1,97
Tuvalu,TUV,2010,7,81,0,2,6,1,97
Tuvalu,TUV,2011,7,82,0,2,6,1,98
Tuvalu,TUV,2012,7,82,0,2,6,1,98
Tuvalu,TUV,2013,8,82,0,2,6,1,99
Tuvalu,TUV,2014,8,84,0,1,6,1,100
Tuvalu,TUV,2015,8,84,0,1,6,1,100
Tuvalu,TUV,2016,8,85,0,1,6,1,101
Tuvalu,TUV,2017,8,86,0,1,6,1,102
Tuvalu,TUV,2018,8,86,0,1,6,1,102
Tuvalu,TUV,2019,8,88,0,1,6,1,104
Uganda,UGA,1990,180038,39475,15719,25211,4755,2372,267570
Uganda,UGA,1991,188985,41516,16256,25478,5120,2618,279973
Uganda,UGA,1992,194966,42766,16422,25718,5309,1731,286912
Uganda,UGA,1993,200893,44497,16524,26664,5581,1749,295908
Uganda,UGA,1994,204168,46240,16297,27582,5902,2024,302213
Uganda,UGA,1995,207395,47837,16177,28662,6169,2615,308855
Uganda,UGA,1996,210265,49390,16009,29885,6489,4292,316330
Uganda,UGA,1997,212843,50621,15676,31020,6829,3734,320723
Uganda,UGA,1998,215405,52218,15205,31985,7009,3830,325652
Uganda,UGA,1999,216317,53354,14571,32903,7189,3849,328183
Uganda,UGA,2000,216401,54835,14145,34060,7430,3653,330524
Uganda,UGA,2001,216621,55877,13973,34960,7749,2660,331840
Uganda,UGA,2002,212794,56381,13540,34925,7762,4814,330216
Uganda,UGA,2003,208318,56756,12672,34655,7820,5894,326115
Uganda,UGA,2004,207644,57776,12788,35570,8080,5006,326864
Uganda,UGA,2005,195565,58380,12431,36382,8149,3916,314823
Uganda,UGA,2006,182113,59010,11799,36742,8178,3146,300988
Uganda,UGA,2007,175264,59379,11184,36785,8147,2903,293662
Uganda,UGA,2008,167961,59313,10392,36391,7912,2795,284764
Uganda,UGA,2009,158794,60054,9866,36376,7764,2929,275783
Uganda,UGA,2010,152490,61229,9923,36883,8268,3055,271848
Uganda,UGA,2011,141596,62811,9881,36929,8046,2943,262206
Uganda,UGA,2012,127630,64995,9874,36913,8184,2931,250527
Uganda,UGA,2013,115376,68223,10897,37557,8734,3177,243964
Uganda,UGA,2014,106705,70611,11207,37574,9012,4157,239266
Uganda,UGA,2015,103954,71928,10442,36592,8939,3474,235329
Uganda,UGA,2016,107338,74226,10387,37945,9202,3533,242631
Uganda,UGA,2017,100901,75391,8907,35779,8910,3525,233413
Uganda,UGA,2018,91746,78196,8391,34559,9121,3732,225745
Uganda,UGA,2019,89018,80311,7761,33076,9097,3443,222706
Ukraine,UKR,1990,11528,541741,521,5178,32773,19435,611176
Ukraine,UKR,1991,11957,571746,533,4904,35186,21729,646055
Ukraine,UKR,1992,12721,599646,541,4460,37360,24849,679577
Ukraine,UKR,1993,13771,628176,554,4117,38806,27074,712498
Ukraine,UKR,1994,15166,649361,577,3947,41443,30007,740501
Ukraine,UKR,1995,17306,680672,598,3684,45208,33317,780785
Ukraine,UKR,1996,17847,665062,579,3428,43721,32958,763595
Ukraine,UKR,1997,17878,642976,549,3181,41247,31084,736915
Ukraine,UKR,1998,16960,610988,525,2945,38633,29145,699196
Ukraine,UKR,1999,18858,628646,538,2760,39950,29999,720751
Ukraine,UKR,2000,20781,643949,532,2564,41221,30925,739972
Ukraine,UKR,2001,20775,635051,476,2357,40323,30434,729416
Ukraine,UKR,2002,20818,645675,437,2131,40021,30591,739673
Ukraine,UKR,2003,21303,647294,401,2013,38144,29774,738929
Ukraine,UKR,2004,22157,659292,371,2017,37500,29953,751290
Ukraine,UKR,2005,25499,672345,334,2021,35427,29884,765510
Ukraine,UKR,2006,24636,650262,300,2166,32395,28430,738189
Ukraine,UKR,2007,25514,666700,294,2405,32732,27264,754909
Ukraine,UKR,2008,25659,668787,283,2397,31009,25448,753583
Ukraine,UKR,2009,22413,617902,242,2280,25276,20932,689045
Ukraine,UKR,2010,21134,605171,220,2182,22816,18530,670053
Ukraine,UKR,2011,20366,586777,203,2071,21361,17034,647812
Ukraine,UKR,2012,20154,589267,192,1974,21118,16593,649298
Ukraine,UKR,2013,17320,586382,174,1790,21394,15611,642671
Ukraine,UKR,2014,18175,556247,177,1775,20811,22037,619222
Ukraine,UKR,2015,21479,646771,215,1905,29203,20744,720317
Ukraine,UKR,2016,21163,628971,211,1765,28449,18515,699074
Ukraine,UKR,2017,20724,625784,208,1629,27544,19215,695104
Ukraine,UKR,2018,20409,639071,208,1498,26733,18982,706901
Ukraine,UKR,2019,19974,636593,206,1386,26304,18971,703434
United Arab Emirates,ARE,2007,533,7616,8,186,2852,458,11653
United Arab Emirates,ARE,2008,593,8235,9,195,3461,605,13098
United Arab Emirates,ARE,2009,652,9050,9,198,4060,742,14711
United Arab Emirates,ARE,2011,724,10592,9,179,4312,827,16643
United Arab Emirates,ARE,2012,760,11492,9,168,4407,859,17695
United Arab Emirates,ARE,2014,814,13107,10,151,4518,936,19536
United Arab Emirates,ARE,2015,860,14321,10,139,4583,956,20869
United Arab Emirates,ARE,1990,301,3127,12,340,993,87,4860
United Arab Emirates,ARE,1991,302,3351,10,310,1056,93,5122
United Arab Emirates,ARE,1992,315,3586,10,283,1120,102,5416
United Arab Emirates,ARE,1993,321,3844,9,252,1187,113,5726
United Arab Emirates,ARE,1994,337,4155,8,224,1244,121,6089
United Arab Emirates,ARE,1995,344,4399,8,198,1313,133,6395
United Arab Emirates,ARE,1996,352,4614,7,177,1371,146,6667
United Arab Emirates,ARE,1997,364,4805,7,169,1439,157,6941
United Arab Emirates,ARE,1998,377,4982,8,173,1499,175,7214
United Arab Emirates,ARE,1999,385,5197,8,183,1576,191,7540
United Arab Emirates,ARE,2000,401,5465,8,189,1622,204,7889
United Arab Emirates,ARE,2001,410,5645,8,195,1701,221,8180
United Arab Emirates,ARE,2002,424,5861,8,198,1757,240,8488
United Arab Emirates,ARE,2003,448,6179,8,196,1869,255,8955
United Arab Emirates,ARE,2004,475,6594,8,186,1962,271,9496
United Arab Emirates,ARE,2005,490,6879,8,178,2016,291,9862
United Arab Emirates,ARE,2006,515,7230,8,173,2274,343,10543
United Arab Emirates,ARE,2010,689,9787,9,190,4200,789,15664
United Arab Emirates,ARE,2013,796,12459,9,159,4393,902,18718
United Arab Emirates,ARE,2016,913,15602,10,127,4649,975,22276
United Arab Emirates,ARE,2017,967,17012,10,115,4714,992,23810
United Arab Emirates,ARE,2018,1015,18505,10,104,4784,1008,25426
United Arab Emirates,ARE,2019,1061,20098,10,95,4861,1022,27147
United Kingdom,GBR,1990,39706,560145,289,3091,13379,2552,619162
United Kingdom,GBR,1991,40817,556949,284,2929,12991,2703,616673
United Kingdom,GBR,1992,42332,553488,280,2692,12505,2720,614017
United Kingdom,GBR,1993,47079,554529,277,2577,12212,2881,619555
United Kingdom,GBR,1994,48651,543066,265,2497,12001,3082,609562
United Kingdom,GBR,1995,51459,543211,263,2442,11900,3050,612325
United Kingdom,GBR,1996,52759,537902,259,2458,11787,3114,608279
United Kingdom,GBR,1997,53557,531519,251,2384,11586,3346,602643
United Kingdom,GBR,1998,53662,530497,251,2313,11514,3651,601888
United Kingdom,GBR,1999,53870,529843,252,2234,11326,3794,601319
United Kingdom,GBR,2000,50909,519611,250,2122,11055,3909,587856
United Kingdom,GBR,2001,45737,513654,257,2027,10815,4170,576660
United Kingdom,GBR,2002,44270,515530,265,2005,10649,4269,576988
United Kingdom,GBR,2003,43268,513436,269,2089,10378,4408,573848
United Kingdom,GBR,2004,41160,500550,265,2065,10019,4430,558489
United Kingdom,GBR,2005,40343,493228,265,2089,9846,4606,550377
United Kingdom,GBR,2006,39460,488551,267,2128,9908,4756,545070
United Kingdom,GBR,2007,39052,486479,267,2143,9837,4901,542679
United Kingdom,GBR,2008,38729,486199,267,2087,9790,4988,542060
United Kingdom,GBR,2009,37803,479387,267,2043,9524,5073,534097
United Kingdom,GBR,2010,37851,479635,266,1971,9209,4970,533902
United Kingdom,GBR,2011,38464,481795,269,1930,8920,4874,536252
United Kingdom,GBR,2012,39727,489804,276,1821,8735,4830,545193
United Kingdom,GBR,2013,40680,496128,273,1704,8783,4855,552423
United Kingdom,GBR,2014,40932,495533,266,1655,8753,4933,552072
United Kingdom,GBR,2015,42042,502649,263,1641,8831,5017,560443
United Kingdom,GBR,2016,41914,504755,262,1631,8915,5106,562583
United Kingdom,GBR,2017,42314,508858,263,1587,9017,5093,567132
United Kingdom,GBR,2018,43565,524896,273,1557,8987,5039,584317
United Kingdom,GBR,2019,44206,533712,277,1524,8997,5020,593736
United States,USA,2007,94195,2073466,8099,16272,94255,62163,2348450
United States,USA,2008,93901,2096195,8187,15709,92869,62278,2369139
United States,USA,2009,92391,2102294,8201,14755,91465,63028,2372134
United States,USA,2010,90834,2113748,8391,13828,89958,64164,2380923
United States,USA,2011,91834,2152311,8730,13652,91399,66695,2424621
United States,USA,2012,92099,2180773,9067,13545,90678,69513,2455675
United States,USA,2013,93528,2216696,9544,13548,91464,72124,2496904
United States,USA,2014,94216,2253457,10186,13472,92765,76576,2540672
United States,USA,2015,95615,2302746,10962,13435,95243,84224,2602225
United States,USA,2016,96565,2347834,11538,13287,97907,92698,2659829
United States,USA,1990,105489,1806785,5214,19844,92870,40788,2070990
United States,USA,1991,110823,1822760,5336,18832,91421,41947,2091119
United States,USA,1992,115635,1838473,5514,17768,89827,41612,2108829
United States,USA,1993,122734,1893875,5896,17211,91441,42990,2174147
United States,USA,1994,128528,1920528,6212,16423,91480,42759,2205930
United States,USA,1995,130356,1954239,6633,15531,91550,42689,2240998
United States,USA,1996,119388,1963863,7039,15039,91304,41027,2237660
United States,USA,1997,105466,1971515,7497,14973,90539,40721,2230711
United States,USA,1998,102539,1995205,8046,15140,90230,41172,2252332
United States,USA,1999,101566,2033344,8739,15351,90158,42215,2291373
United States,USA,2000,99534,2051239,9021,15445,90734,43902,2309875
United States,USA,2001,98191,2065266,8991,15267,92129,50994,2330838
United States,USA,2002,98669,2080282,8941,15473,93380,50131,2346876
United States,USA,2003,98022,2080210,8693,15769,94000,53088,2349782
United States,USA,2004,95894,2054254,8369,15780,92854,55634,2322785
United States,USA,2005,96570,2074285,8339,16112,97973,58975,2352254
United States,USA,2006,95552,2073590,8123,16263,94938,61498,2349964
United States,USA,2017,97392,2369404,11267,12743,96535,96480,2683821
United States,USA,2018,100172,2444599,11499,12271,95393,98048,2761982
United States,USA,2019,102956,2513770,11800,11984,94047,100407,2834964
United States Virgin Islands,VIR,1990,24,493,6,22,35,46,626
United States Virgin Islands,VIR,1991,25,499,6,21,37,46,634
United States Virgin Islands,VIR,1992,26,514,6,19,36,45,646
United States Virgin Islands,VIR,1993,28,535,6,18,37,45,669
United States Virgin Islands,VIR,1994,31,555,6,18,37,44,691
United States Virgin Islands,VIR,1995,30,562,6,17,45,46,706
United States Virgin Islands,VIR,1996,32,579,6,16,38,46,717
United States Virgin Islands,VIR,1997,30,588,6,15,37,46,722
United States Virgin Islands,VIR,1998,29,603,6,14,37,47,736
United States Virgin Islands,VIR,1999,32,629,6,13,40,48,768
United States Virgin Islands,VIR,2000,34,645,6,13,37,49,784
United States Virgin Islands,VIR,2001,35,664,6,12,37,50,804
United States Virgin Islands,VIR,2002,35,675,6,11,36,49,812
United States Virgin Islands,VIR,2003,33,691,6,11,34,50,825
United States Virgin Islands,VIR,2004,32,707,6,10,33,49,837
United States Virgin Islands,VIR,2005,31,725,6,10,32,50,854
United States Virgin Islands,VIR,2006,31,764,6,10,32,51,894
United States Virgin Islands,VIR,2007,32,894,6,9,29,45,1015
United States Virgin Islands,VIR,2008,32,917,6,9,29,45,1038
United States Virgin Islands,VIR,2009,33,937,6,9,29,46,1060
United States Virgin Islands,VIR,2010,33,959,6,8,30,46,1082
United States Virgin Islands,VIR,2011,32,978,6,7,30,46,1099
United States Virgin Islands,VIR,2012,33,1000,6,7,31,45,1122
United States Virgin Islands,VIR,2013,33,1018,7,6,31,45,1140
United States Virgin Islands,VIR,2014,35,1037,7,6,31,44,1160
United States Virgin Islands,VIR,2015,37,1059,7,5,31,44,1183
United States Virgin Islands,VIR,2016,35,1071,7,5,31,43,1192
United States Virgin Islands,VIR,2017,35,1090,8,5,38,43,1219
United States Virgin Islands,VIR,2018,35,1110,8,5,31,42,1231
United States Virgin Islands,VIR,2019,35,1127,8,4,31,41,1246
Uruguay,URY,1990,1314,24975,155,601,1081,210,28336
Uruguay,URY,1991,1360,24919,156,600,1133,176,28344
Uruguay,URY,1992,1367,25221,146,569,1152,210,28665
Uruguay,URY,1993,1439,25652,142,587,1201,232,29253
Uruguay,URY,1994,1429,25452,136,569,1221,239,29046
Uruguay,URY,1995,1492,25820,134,574,1250,239,29509
Uruguay,URY,1996,1544,25814,134,540,1264,244,29540
Uruguay,URY,1997,1543,25754,149,504,1315,269,29534
Uruguay,URY,1998,1626,26435,164,466,1362,297,30350
Uruguay,URY,1999,1666,26550,168,421,1364,297,30466
Uruguay,URY,2000,1627,26047,172,396,1342,294,29878
Uruguay,URY,2001,1648,25942,179,385,1324,286,29764
Uruguay,URY,2002,1671,26275,183,384,1344,296,30153
Uruguay,URY,2003,1749,26745,193,393,1329,267,30676
Uruguay,URY,2004,1776,26769,201,351,1322,264,30683
Uruguay,URY,2005,1775,26428,194,312,1319,271,30299
Uruguay,URY,2006,1726,26017,192,278,1330,287,29830
Uruguay,URY,2007,1843,26803,205,279,1392,293,30815
Uruguay,URY,2008,1787,25936,201,255,1372,300,29851
Uruguay,URY,2009,1793,25610,202,237,1382,315,29539
Uruguay,URY,2010,1861,25918,211,237,1417,324,29968
Uruguay,URY,2011,1968,26808,226,236,1457,336,31031
Uruguay,URY,2012,2009,26828,232,220,1473,368,31130
Uruguay,URY,2013,1972,26596,234,210,1471,375,30858
Uruguay,URY,2014,1957,26451,237,189,1449,383,30666
Uruguay,URY,2015,1976,26814,242,181,1447,402,31062
Uruguay,URY,2016,2001,26969,243,177,1440,398,31228
Uruguay,URY,2017,2003,27368,241,172,1417,374,31575
Uruguay,URY,2018,2003,27640,239,165,1391,366,31804
Uruguay,URY,2019,2009,27989,238,158,1364,361,32119
Uzbekistan,UZB,1990,26124,82122,336,9060,8051,2033,127726
Uzbekistan,UZB,1991,25946,87797,345,9039,8158,2086,133371
Uzbekistan,UZB,1992,26359,95908,344,9003,8148,2182,141944
Uzbekistan,UZB,1993,26956,107344,329,8931,8384,2401,154345
Uzbekistan,UZB,1994,27324,116749,304,8851,8614,2515,164357
Uzbekistan,UZB,1995,27546,122569,282,8909,8952,2618,170876
Uzbekistan,UZB,1996,27341,127965,256,8778,9398,2726,176464
Uzbekistan,UZB,1997,26553,128903,223,8635,9455,2655,176424
Uzbekistan,UZB,1998,25870,130921,187,8455,9691,2612,177736
Uzbekistan,UZB,1999,24824,131963,160,8372,9824,2600,177743
Uzbekistan,UZB,2000,24084,138364,146,8372,10106,2800,183872
Uzbekistan,UZB,2001,23298,142430,138,8226,10240,2428,186760
Uzbekistan,UZB,2002,22818,147632,117,8156,10297,2249,191269
Uzbekistan,UZB,2003,22343,152424,104,8263,10306,1966,195406
Uzbekistan,UZB,2004,22012,156489,94,8207,10415,1968,199185
Uzbekistan,UZB,2005,21961,163336,85,8204,10812,1967,206365
Uzbekistan,UZB,2006,21291,158780,79,8268,10598,1773,200789
Uzbekistan,UZB,2007,20753,157347,73,8303,10641,1729,198846
Uzbekistan,UZB,2008,20059,157623,66,8294,10404,1745,198191
Uzbekistan,UZB,2009,19199,155337,58,8254,10148,1763,194759
Uzbekistan,UZB,2010,18553,155654,54,8083,10039,1798,194181
Uzbekistan,UZB,2011,18158,159762,53,7892,10255,1690,197810
Uzbekistan,UZB,2012,17710,163120,54,7593,10492,1796,200765
Uzbekistan,UZB,2013,17098,163689,55,7338,10606,1742,200528
Uzbekistan,UZB,2014,16665,165556,58,7094,10630,1660,201663
Uzbekistan,UZB,2015,16200,167642,51,6765,11142,1742,203542
Uzbekistan,UZB,2016,15706,169767,51,6392,11248,1819,204983
Uzbekistan,UZB,2017,15167,171858,50,6053,11116,1796,206040
Uzbekistan,UZB,2018,14688,174242,50,5747,11022,1822,207571
Uzbekistan,UZB,2019,14283,175418,50,5485,11003,1864,208103
Vanuatu,VUT,1990,266,608,22,80,70,5,1051
Vanuatu,VUT,1991,245,643,22,80,76,5,1071
Vanuatu,VUT,1992,231,677,22,81,84,6,1101
Vanuatu,VUT,1993,224,702,22,82,89,8,1127
Vanuatu,VUT,1994,205,738,22,83,90,8,1146
Vanuatu,VUT,1995,217,746,22,84,91,8,1168
Vanuatu,VUT,1996,211,771,22,85,96,8,1193
Vanuatu,VUT,1997,213,790,23,87,199,8,1320
Vanuatu,VUT,1998,214,809,23,88,102,8,1244
Vanuatu,VUT,1999,220,838,26,90,150,8,1332
Vanuatu,VUT,2000,246,837,26,92,108,8,1317
Vanuatu,VUT,2001,245,869,26,93,111,8,1352
Vanuatu,VUT,2002,294,861,26,94,108,8,1391
Vanuatu,VUT,2003,328,863,24,93,107,8,1423
Vanuatu,VUT,2004,328,896,24,93,111,8,1460
Vanuatu,VUT,2005,304,956,24,94,116,9,1503
Vanuatu,VUT,2006,295,1002,24,93,118,9,1541
Vanuatu,VUT,2007,282,1060,26,94,125,10,1597
Vanuatu,VUT,2008,273,1112,26,93,127,10,1641
Vanuatu,VUT,2009,277,1152,25,93,131,10,1688
Vanuatu,VUT,2010,269,1195,25,92,133,10,1724
Vanuatu,VUT,2011,253,1259,24,91,137,10,1774
Vanuatu,VUT,2012,244,1303,24,88,139,10,1808
Vanuatu,VUT,2013,239,1353,24,86,141,10,1853
Vanuatu,VUT,2014,237,1402,24,85,155,10,1913
Vanuatu,VUT,2015,239,1449,23,83,156,10,1960
Vanuatu,VUT,2016,245,1498,24,83,149,10,2009
Vanuatu,VUT,2017,248,1543,24,81,152,11,2059
Vanuatu,VUT,2018,248,1589,24,79,153,11,2104
Vanuatu,VUT,2019,251,1636,24,77,154,11,2153
Venezuela,VEN,1990,10317,53297,1574,7540,7236,3256,83220
Venezuela,VEN,1991,9094,55322,1401,6223,7371,3683,83094
Venezuela,VEN,1992,9334,57358,1503,6243,7651,4185,86274
Venezuela,VEN,1993,9600,59503,1697,6430,8108,4610,89948
Venezuela,VEN,1994,10276,63398,1967,6897,8432,5395,96365
Venezuela,VEN,1995,9812,64452,2135,6863,8338,5126,96726
Venezuela,VEN,1996,9397,64035,2255,6588,7859,5000,95134
Venezuela,VEN,1997,9013,63819,2155,6176,7633,4670,93466
Venezuela,VEN,1998,8914,67116,2182,6009,8004,5169,97394
Venezuela,VEN,1999,8554,69335,2060,5580,38426,6355,130310
Venezuela,VEN,2000,8130,71098,1951,5324,8330,8220,103053
Venezuela,VEN,2001,7939,74338,1942,5421,8622,9033,107295
Venezuela,VEN,2002,7954,78806,1881,5367,8408,9428,111844
Venezuela,VEN,2003,8764,83154,2030,6218,8812,10454,119432
Venezuela,VEN,2004,8262,81474,1623,5437,8444,9856,115096
Venezuela,VEN,2005,8016,84225,1359,5124,8215,9628,116567
Venezuela,VEN,2006,8009,89697,1229,4911,8414,10260,122520
Venezuela,VEN,2007,8185,94219,1154,5017,8769,11055,128399
Venezuela,VEN,2008,8284,99380,1096,5224,9126,11720,134830
Venezuela,VEN,2009,8513,101232,1026,5446,9071,12409,137697
Venezuela,VEN,2010,8568,98478,968,5514,9019,12522,135069
Venezuela,VEN,2011,8994,101728,927,5463,9069,12804,138985
Venezuela,VEN,2012,9268,106544,905,5445,9523,13866,145551
Venezuela,VEN,2013,9386,107829,898,5430,9679,13950,147172
Venezuela,VEN,2014,9560,112211,940,5466,9892,13588,151657
Venezuela,VEN,2015,9705,116372,959,5180,9886,13652,155754
Venezuela,VEN,2016,9777,122515,983,4681,9459,12869,160284
Venezuela,VEN,2017,9874,127969,1000,4207,9101,11845,163996
Venezuela,VEN,2018,10042,133594,1022,3964,9109,11558,169289
Venezuela,VEN,2019,10591,145268,1079,3835,9237,11315,181325
Vietnam,VNM,2007,57978,379658,1646,12981,36385,4178,492826
Vietnam,VNM,2008,57176,391244,1616,12759,38770,4256,505821
Vietnam,VNM,2009,56387,403183,1579,12541,39479,4260,517429
Vietnam,VNM,2011,56234,424827,1480,11679,40066,4306,538592
Vietnam,VNM,2014,54020,459866,1279,9775,39765,4132,568837
Vietnam,VNM,2015,53125,470215,1206,9134,39764,4224,577668
Vietnam,VNM,2016,52143,482327,1135,8487,39797,4307,588196
Vietnam,VNM,1990,68467,268399,3308,28256,31432,3883,403745
Vietnam,VNM,1991,67010,271373,3214,27215,31358,3948,404118
Vietnam,VNM,1992,65583,274175,3079,25965,30670,3999,403471
Vietnam,VNM,1993,63750,277590,2929,24654,30197,4053,403173
Vietnam,VNM,1994,61873,281370,2770,23358,29836,4100,403307
Vietnam,VNM,1995,59691,285637,2616,22094,29416,4118,403572
Vietnam,VNM,1996,57997,290574,2440,20866,29835,4129,405841
Vietnam,VNM,1997,56804,295375,2236,19657,32289,4148,410509
Vietnam,VNM,1998,56021,300500,2045,18540,28895,4167,410168
Vietnam,VNM,1999,55269,306069,1890,17570,29194,4160,414152
Vietnam,VNM,2000,55307,311453,1787,16536,28948,4105,418136
Vietnam,VNM,2001,55634,319288,1738,15605,29456,4147,425868
Vietnam,VNM,2002,55900,327697,1709,14874,30190,4140,434510
Vietnam,VNM,2003,56723,337389,1715,14337,31426,4176,445766
Vietnam,VNM,2004,57353,347742,1718,13886,32813,4141,457653
Vietnam,VNM,2005,57801,357789,1701,13494,34007,4121,468913
Vietnam,VNM,2006,58323,367887,1671,13174,34887,4111,480053
Vietnam,VNM,2010,56071,413407,1533,12148,39884,4276,527319
Vietnam,VNM,2012,55741,436134,1418,11056,40227,4395,548971
Vietnam,VNM,2013,55127,447728,1350,10377,39751,4509,558842
Vietnam,VNM,2017,51213,494578,1065,7839,39736,4373,598804
Vietnam,VNM,2018,50275,506763,1057,7222,39392,4423,609132
Vietnam,VNM,2019,49577,518492,1049,6702,38978,4460,619258
Yemen,YEM,2007,27388,60708,3708,28049,12719,1269,133841
Yemen,YEM,2008,25362,62885,3519,28123,13229,1415,134533
Yemen,YEM,2009,24685,64166,3267,27804,13053,1477,134452
Yemen,YEM,2010,24818,64949,3020,27010,12602,1837,134236
Yemen,YEM,2011,23289,67078,2856,26476,12778,3066,135543
Yemen,YEM,2012,22046,68815,2628,25731,12658,4720,136598
Yemen,YEM,2013,20630,70987,2491,25067,13053,2573,134801
Yemen,YEM,2014,20227,72701,2309,24053,13010,4846,137146
Yemen,YEM,2015,19375,75641,2198,23273,13478,9562,143527
Yemen,YEM,1990,40721,39907,8289,26729,10265,801,126712
Yemen,YEM,1991,40548,40746,7928,26705,10234,804,126965
Yemen,YEM,1992,40439,41739,7535,26738,10263,836,127550
Yemen,YEM,1993,40303,42757,7201,26790,10343,824,128218
Yemen,YEM,1994,39790,43842,6868,26769,10389,2345,130003
Yemen,YEM,1995,39458,44884,6598,26747,10454,854,128995
Yemen,YEM,1996,39015,45875,6484,26892,10882,867,130015
Yemen,YEM,1997,38621,46927,6221,27078,10638,893,130378
Yemen,YEM,1998,38082,47816,6013,27124,10811,910,130756
Yemen,YEM,1999,36802,49201,5777,27086,10896,938,130700
Yemen,YEM,2000,35603,50422,5555,27058,11035,975,130648
Yemen,YEM,2001,34572,51542,5242,27127,11140,978,130601
Yemen,YEM,2002,33850,53228,5083,27504,11618,1033,132316
Yemen,YEM,2003,32825,54577,4726,27695,11737,1086,132646
Yemen,YEM,2004,31154,55997,4361,27885,11858,1132,132387
Yemen,YEM,2005,29430,57316,4041,27847,12017,1160,131811
Yemen,YEM,2006,27585,58950,3765,27859,12102,1200,131461
Yemen,YEM,2016,19820,78548,2093,22424,13873,17556,154314
Yemen,YEM,2017,21155,82044,1983,21656,14298,18716,159852
Yemen,YEM,2018,19958,85496,1960,21183,14813,32715,176125
Yemen,YEM,2019,20370,88469,1951,20687,14959,15058,161494
Zambia,ZMB,1990,60228,22448,8361,9479,2834,937,104287
Zambia,ZMB,1991,66932,23391,8367,9591,2938,925,112144
Zambia,ZMB,1992,73563,24158,8321,9687,3006,971,119706
Zambia,ZMB,1993,78983,24848,8214,9770,3075,1011,125901
Zambia,ZMB,1994,85362,25650,8093,9924,3131,1054,133214
Zambia,ZMB,1995,91820,26459,7931,10101,3201,1099,140611
Zambia,ZMB,1996,97105,27170,7695,10256,3235,1135,146596
Zambia,ZMB,1997,101405,27734,7452,10370,3268,1170,151399
Zambia,ZMB,1998,105083,28265,7272,10529,3279,1210,155638
Zambia,ZMB,1999,108352,28684,7075,10664,3284,1251,159310
Zambia,ZMB,2000,110440,29088,6969,10793,3333,1266,161889
Zambia,ZMB,2001,114916,29333,6729,10930,3356,1294,166558
Zambia,ZMB,2002,111703,29807,6504,11101,3378,1313,163806
Zambia,ZMB,2003,110064,30416,6438,11365,3485,1365,163133
Zambia,ZMB,2004,107117,31119,6618,11645,3638,1439,161576
Zambia,ZMB,2005,102900,31659,6578,11867,3723,1515,158242
Zambia,ZMB,2006,97731,32462,6487,12041,3814,1577,154112
Zambia,ZMB,2007,89295,32802,6198,12183,3828,1641,145947
Zambia,ZMB,2008,79086,33365,6010,12215,3833,1682,136191
Zambia,ZMB,2009,72098,33959,5600,12053,3803,1740,129253
Zambia,ZMB,2010,69241,35208,5493,11885,3856,1786,127469
Zambia,ZMB,2011,66459,36495,5356,11746,3924,1815,125795
Zambia,ZMB,2012,62950,37339,5042,11577,3925,1833,122666
Zambia,ZMB,2013,60763,38434,4957,11454,3978,1877,121463
Zambia,ZMB,2014,59243,39641,4706,11210,4058,1925,120783
Zambia,ZMB,2015,57872,41003,4468,11104,4155,1987,120589
Zambia,ZMB,2016,56386,42597,4226,11006,4214,2051,120480
Zambia,ZMB,2017,55717,44265,4103,10906,4305,2104,121400
Zambia,ZMB,2018,53905,45558,3838,10767,4321,2161,120550
Zambia,ZMB,2019,52115,46925,3727,10655,4372,2207,120001
Zimbabwe,ZWE,1990,33587,23734,4269,8049,3908,1207,74754
Zimbabwe,ZWE,1991,39209,24220,3998,7970,3923,1178,80498
Zimbabwe,ZWE,1992,46965,25202,3816,7978,4067,1205,89233
Zimbabwe,ZWE,1993,57404,25657,3402,7960,4067,1183,99673
Zimbabwe,ZWE,1994,67081,26410,3332,8016,4316,1226,110381
Zimbabwe,ZWE,1995,79422,27187,3062,7999,4460,1236,123366
Zimbabwe,ZWE,1996,91141,27367,2800,7915,4268,1185,134676
Zimbabwe,ZWE,1997,101795,27979,2757,7914,4272,1203,145920
Zimbabwe,ZWE,1998,112473,29340,2818,8017,4477,1274,158399
Zimbabwe,ZWE,1999,122434,30741,3055,8154,4584,1348,170316
Zimbabwe,ZWE,2000,130157,32543,3235,8305,4825,1456,180521
Zimbabwe,ZWE,2001,134811,33245,3351,8417,4714,1499,186037
Zimbabwe,ZWE,2002,138768,34385,3504,8610,4730,1564,191561
Zimbabwe,ZWE,2003,141221,35177,3616,8866,4713,1543,195136
Zimbabwe,ZWE,2004,141410,36250,3694,9210,4744,1549,196857
Zimbabwe,ZWE,2005,138589,36459,3872,9543,4763,1556,194782
Zimbabwe,ZWE,2006,133383,37323,4146,9981,4855,1541,191229
Zimbabwe,ZWE,2007,127044,38207,4410,10329,5041,1531,186562
Zimbabwe,ZWE,2008,119201,40163,5082,10868,5518,2024,182856
Zimbabwe,ZWE,2009,109964,41188,5272,11136,5642,1706,174908
Zimbabwe,ZWE,2010,95594,41542,5498,11311,5733,1734,161412
Zimbabwe,ZWE,2011,83555,41254,5996,11278,5771,1760,149614
Zimbabwe,ZWE,2012,74487,41295,6160,11064,5796,1795,140597
Zimbabwe,ZWE,2013,69142,41396,6004,10885,5861,1788,135076
Zimbabwe,ZWE,2014,65872,42122,5925,10759,5815,1812,132305
Zimbabwe,ZWE,2015,62555,42972,6009,10633,6026,1885,130080
Zimbabwe,ZWE,2016,59818,43821,6083,10403,6212,1937,128274
Zimbabwe,ZWE,2017,57237,44611,5952,10213,6534,1968,126515
Zimbabwe,ZWE,2018,53933,45397,5808,9991,6363,2014,123506
Zimbabwe,ZWE,2019,52373,46352,5739,9903,7106,2067,123540